古代帝王的女婿，也就是公主的丈夫通常被称为什么爷	驸马爷
位于内蒙古自治区，以盛产羊绒和煤炭而闻名的城市叫做什么	鄂尔多斯
94男足世界杯上，身穿7号球衣，与罗马里奥合称“梦幻组合”的巴西球员是谁	贝贝托
师从多明戈，具有“亚洲第一男中音”美誉的是我国哪位著名男歌唱家	廖昌永
赵咏华的《最浪漫的事》中，“我能想到最浪漫的事，就是和你一起怎么样”	《最浪漫的事》一首由姚若龙作词,李正帆作曲的名曲
梁山首领，外号“及时雨”的谁	梁山老大宋江的名号
地球的直径是多少	赤道半径
为什么会大规模传染疾病	●中国没有记录
二战时期，为德国海军提出了群狼战术的海军元帅是	邓尼茨 当时他不是海军元帅,当时是是雷德尔
现代原子钟每170万年只有多少误差	1
诗句“少壮不努力”的下句是什么	　　少壮不努力,老大徒伤悲
南唐后主李煜被杀是因为自己作的哪首词被宋太祖认为想谋反	《虞美人》
2012年欧洲冠军联赛总决赛中哪支队伍通过点球大战首次夺得冠军杯	2012年欧洲冠军联赛总决赛中哪支队伍通过点球大战首次夺得冠军杯
被称为“地球之肺”的是哪片位于南美洲的热带雨林	亚马逊
博鳌亚洲论坛在我国哪个省举办	海南省 琼海市 博鳌镇 如有帮助 请采纳
陕北名歌中唱到，什么花开红艳艳	山丹丹
“这是最好的时代，也是最坏的时代。”是哪部世界名著的开场白	双城记
美国著名网球运动员，一对黑人姐妹花，她们姓什么	威廉姆斯
谚语“男怕入错行”的下一句是	嫁错郎
爱斯基摩人爱吃生肉的重要原因之一是什么	为了补充维生素
被称为“西方文明的摇篮”，民主政治的起源地是古希腊的哪个城邦	古希腊的 雅典
中国古代的足球运动在公元前年就已盛行，当时这项运动叫什么	蹴鞠
插花节是在农历几月份	插花节是彝族的风俗习惯
美国前总统乔治·沃克·布什所属政党是美国什么党	是乔治沃克布什属于共和党
国家最少的大陆是哪块	深圳
“环肥燕瘦”中的“燕”指的是谁	赵飞燕 赵飞燕 生于前45年 卒于前1年 赵飞燕原名宜生，是汉代著名的舞蹈家，因其舞姿轻盈如燕飞凤舞，故人们称其为“飞燕”
潜水员的脚蹼是根据哪种两栖动物发明的	潜水员的脚蹼是根据哪种两栖动物发明的? 青蛙
台湾第一位巡抚，被称为“台湾近代化之父”的是谁	刘铭传
诗句“不要人夸颜色好，只留清气满乾坤”歌颂的是哪种花	梅花
被成为“曼联国王”，四次带领曼联获得英超冠军的球星是谁	埃里克坎通纳
云南的昆明又叫什么	昆明又叫做什么昆明简介昆明市是云南省省会,全省的政治、经济、文化中心,也是全国历史文化名城之
以潘冬子为主角的是哪一部中国儿童红色经典电影	《闪闪的红星》
春秋时一对著名的铸剑师夫妻，一个叫干将，另一个叫什么	莫邪
南非是世界上唯一同时有三个首都的国家，请问南非的的立法首都也是南非第二大城市的是	而南非也是世界上唯一同时存在三个首都的国家
2011年由宫晓东指导的《穆桂英挂帅》中，穆桂英的饰演者是哪位内地著名女演员	苗圃v 的饰演
《西游记》中，沙和尚的法号叫什么	沙僧:法名悟净,人称沙和尚,原是天宫玉帝的卷帘大将,因打破了琉璃盏,触犯天条,被贬出天界,在人间流沙河兴风作浪
新疆唯一一个以石油命名的是哪个城市	克拉玛依
哪条山脉位于尼泊尔和我国的交界处	喜马拉雅山脉位于青藏高原南巅边缘,是世界海拔最高的山脉,其中有110多座山峰高达或超过海拔7350米
阿拉斯加州的海岸线长度是多少	美国 美利坚合众国地处北美洲中部，东临大西洋，西滨太平洋，北接加拿大，南靠墨西哥及墨西哥湾
初中语文课本中必学篇目《爱莲说》是哪位北宋学者所做	周敦
运动型多用途越野车的英文简称是由哪三个字母组成的	SUV - sport-utility vehicle 多功能箱式跑车,运动型多用途运载车
银河系有多宽	银河系很大的
中国十大传世名画之一的《洛神赋图》的作者是东晋时期的哪位画家	顾恺之
崔莺莺是元代剧作家王实甫的哪部戏剧作品里的现实人物和文学形象	西厢记
在白居易的《长恨歌》中，“七月七日长生殿”的下句是什么	半夜无人私语时
北京最著名的旅馆叫什么	西直门经济酒店在你所要求的价位只能看看地下室的旅馆了,要不然就去看看团购什么的
电脑中最常用的中文字体是什么	Winkawaks1.59汉化版这个模拟器就有了
中国古代追赶太阳的神话人物是谁	夸父追日
由于毛孔堵塞而生长在鼻子上的黑色细小颗粒俗称为什么	俗称为 黑头
蒙古族人民口中的“毡包”实际上指的是哪种物品	实际上指的是 蒙古包
doc是微软哪一款文件笔记软件的后缀名	word
最低级的计算机语言是什么语言	请熊熊参考下面的代码
Facebook创始人马克.扎克伯格是哪个美国著名高校的辍学生	哈佛 的辍学
陇海铁路是从江苏连云港通往哪个城市的铁路干线	兰州 的铁路干线
机器猫哆啦a梦因为头部没有哪个器官而经常被人嘲笑	耳朵
金庸小说《笑傲江湖》中，令狐冲和任盈盈第一次相遇是在洛阳的哪条巷子里	在洛阳遇见的 其师带领令等人到金刀王元霸家时,在洛阳东城遇见一老婆婆 即是盈盈 在小说的第一十三章<学琴>中段可是出现
在太阳系八大行星中，质量和体积最小的是哪一颗	质量和体积最小的是水
我国水土流失最为严重的高原是哪个高原	黄土高原
《水浒传》中梁山好汉有多少位	108
电影《画皮》的故事出自哪本清代文言短篇小说集	《聊斋志异》哦
故宫位于北京市中心，其明清时期的旧称是什么	故宫位于北京市中心,旧称紫禁城
“名不正言不顺”是春秋战国时期哪一家的思想理论	 儒家
清朝晚期首府新疆和镇压陕甘地区变乱的是哪位洋务运动首领	左宗棠
歌手光良与品冠曾经的组合叫什么名字	无印良品
“三星堆遗址”位于我国的哪个省境内	四川省
胆汁是哪里分泌的	通知:说胆囊分泌胆汁的人请立即回中学补课或到医院体
出自《增广贤文》，反映古代读书人专心学习，“两耳不闻窗外事”的下一句是	一心只读圣贤书
地球总面积大约是多少	4400
“单骑救主”“白衣渡江”都出自我国哪部古典名著	 《三国演义》
618被公认为最具有审美一役的比例数字，请问它被称作什么分割点	黄金分割点
我国哪位相声艺术家是直系军阀冯国璋的曾孙	冯巩,我是猜的,不然没想到还有哪位艺术家姓冯还这么有影响力的了
由杨幂主演的清宫剧《宫》的剧名全称是什么	宫锁心玉
中国四大名砚中，产于广东肇庆的是什么砚	国四大名砚 即端砚、歙砚、洮砚和澄泥砚歙砚 歙砚又称“龙尾砚”、“婺源砚”，砚石产于江西婺源龙尾山，婺源古属歙州，故名
电影《龙门飞甲》中陈坤饰演的西厂督主叫什么	雨化田
影星李嘉欣是中国和哪个国家的混血儿	一、费翔(中美混血) 老少妇孺皆知的偶像,80年代末风靡于两岸的歌
女士常常吃木瓜炖哪种蛙种，可以滋润养颜	雪蛤
“生死一知己，存亡两妇人”形容的是哪位秦末汉初军事家	韩信
我国面积最大、陆地边境线最长、毗邻国家最多的是哪个省级行政区	新疆我国面积最大、陆地边境线最长、毗邻国家最多的
著名的宫廷洋画师朗世宁任职于哪位清朝皇帝在位期间	乾隆 在位期间
中国在2012年伦敦奥运会上，谁获得了最后一枚金牌	邹市明
著名的烧酒品牌“真露”是哪个国家特产酒	韩国
水的密度是多少	1
我国最早的一部医学理论著作是什么	问题：我国最早的一部医学理论著作是： 答案： B A： 《本草纲目》 B： 《黄帝内经》 C： 《千金方》 D： 《伤寒杂病论
泰国男演员马里奥.毛瑞尔在哪部泰国青春爱情喜剧电影中扮演阿亮学长	初恋这件小事
著名哲学家黑格尔是哪个国家的	黑格尔:德国近代客观唯心主义哲学的代表、政治哲学家
《不得不爱》是由弦子和哪位男歌手共同演唱的	潘玮柏
1940年版电影《魂断蓝桥》中，女主角米拉的扮演者是哪位传奇女星	费雯丽
现代足球源于哪个国家	古代足球起源于中国，现代足球起源于英国  足球的发源地到底是哪
西方的哪个节日期间，孩子们会在田间做寻找彩蛋的游戏	复活
在单反镜头上，我们用“A”表示自动对焦，那么我们用哪个字母表示手动对焦	A是自动对焦,M是手动,这个谁都
每年的“诺贝尔和平奖”都会由哪个北欧国家的诺贝尔委员会颁发	挪威
朱元璋是哪个朝代的皇帝	朱元璋朝代的元帅叫什么挺多的,出名的有徐达,常遇春,蓝玉
”杨子荣的回答是什么	你说我是共军,就算我是共军
平假名都是由中国的汉子草书演化过来的，那么平假名属于哪种语言	日语
“士别三日当刮目相待”说的哪位吴国名将	吕蒙
诸葛亮隐居隆中时，常自比管仲和哪位历史人物	乐毅
“洋灰”是对哪种建筑用品的旧称	水泥
相传“露马脚”的典故是我国古代哪位皇帝的皇后	朱元璋10、
出自冯梦龙《警世通言》，“光阴似箭”的下一句是什么	日月如梭
移动公司推出了什么促销活动	“放心回家”业务,指定两个城市作为漫游地优惠城市,寒假期间有效
我国法律规定年满多少周岁就有选举权和被选举权	18
出自王安石的《元日》，“千门万户曈曈日”的下一句是什么	桃符换旧 出处 宋王安石《元日诗》:「爆竹声中一岁除,春风送暖入屠苏;千门万户曈曈日,总把新桃换旧符.」 释义 桃符,[1]旧时门旁所设的
网络用语中，用哪两个相同的字母称呼男孩子	GG
哪个是湖非洲最深的湖泊	是非洲第二大湖(第一大湖是维多利亚湖L.Victoria),湖面海拔高度774m,湖区最深处达1470m,是非洲最深的湖泊,仅次于俄罗斯的贝加尔湖,是世界第二深湖
为什么会发生月食	月食的原理和日食类
代表作有《闲话中国人》、《读城记》的我国著名作家、学者是谁	易中天
珠穆朗玛峰位于我国与哪个国家的交界处	珠穆朗玛峰,位于我国西藏自治区和尼泊尔交界处.珠穆朗玛峰是喜玛拉雅山主峰,世界最高的山峰,海拔8848.13米
2012年因兴奋剂事件被终身禁赛，曾创造了环法车手七连冠奇迹的是哪位美国运动员	阿姆斯特朗
哪个宗教提倡慈爱合同、济世度人	主张把人性善良的一面发扬光大,把恶性的一面去掉.人类社会各种宗教都能相互共存,相互宽容,人与人之间也应该能够相互宽容,和谐发展,共存共荣
我们常说的“五险一金”中，“一金”指的是什么	1、“五险”指的是五种保险,包括养老保险、医疗保险、失业保险、工伤保险和生育保险;“一金”指的是住房公积金
我国长江流域和黄河流域的分水岭是什么	秦岭
著名日本漫画《灌篮高手》的作者是哪位漫画家	著名漫画家井上雄彦
北京的旧书市有哪些	如果就名气而论,北京淘旧书的地方最有名的,主渠道当属老字号的中国书店,二渠道则不能不提潘家园和以前五道口的旧书市场
近期上映的由斯皮尔伯格导演，以一战为背景的动物题材题片叫什么名字	近期上映的由斯皮尔伯格导演,以一战为背景的动物题材题片叫 什么名字? 《战马》
拿破仑兵败的“滑铁卢”位于欧洲哪个国家	滑铁卢位于比利时境内
地球上重量最大的动物是什么	蓝鲸体长可达33米，体重190吨，相当于33头大象或300多头黄牛的体重，它的一条舌头就有4吨重
麻将应对的五种标准状态，是“吃”、“碰”、“听”、“胡”和什么	麻将应对的五种标准状态,是“吃”、“碰”、“杠”、“听”、“胡”
今年，朱茵与哪位香港音乐人产下一女	黄贯中
我国每年用电量多少	2015
干电池的负极是用什么金属制成的	正极:石墨碳棒,外端加镀锌铜帽 负极:锌皮
《阿拉蕾》《七龙珠》是哪位日本著名漫画家的代表作	鸟山明
《火影忍者》中宇智波家族独特的瞳术是	写轮
东晋大诗人陶渊明被称为五柳先生是因为为什么	是的
我们常用“早晨哪两个时间点的太阳”形容青少年朋友	七八点
俗语“一九二九不出手”的下一句是什么	三九四九冰上走
中国哪个传统节日又叫“团圆节”	中秋节别称:月夕、秋节、仲秋节、八月节、八月会、追月节、玩月节、拜月节、女儿节、团圆
核武器有哪几种	核武器分为战略核 武 器,战术核 武 器, 战略核 武器一般都是弹道导弹,或者核轰 炸机携带的核 弹 战术核 武器是巡航导弹携带核 弹 头 分为三代
南美洲国家厄瓜多尔的首都是哪个城市	首都是 基多
树木在日照下主要释放的是哪种气体	?氧气
著名史学家班彪的幼子，东汉时期出使西域的著名军事家外交家是谁	班超
司马迁说，人固有一死，或重于泰山，下一句是什么	或轻于鸿毛
一代歌后邓丽君上世界80年代初曾与哪位香港功夫巨星相恋	成龙 成龙
出自辛弃疾《西江月》，“七八个星天外”的下一句是什么	两三点雨山前
著名演员李嘉欣的丈夫是哪位豪门子弟	许晋亨
经济大萧条是什么时候	经济大萧条时,黑社会和娱乐产业会繁荣发展
英国首相官邸和中央政府机关位于哪条著名的街道	唐宁街
歌词“外面是共产主义接班人，沿着革命先辈的光荣路程”是哪个组织的队歌	少先
哪个节气前后，太阳在天空中的位置最高	C、夏至时,太阳直射北回归线,北半球太阳在天空的位置最高
我们平时常说的“关中地区”位于我国哪个省	 陕西省
歇后语中常用“猴子捞什么”比喻空忙一场	月亮
“世界上最远的距离，不是生与死，而是我站在你的面前，你却不知道我爱你。”出自哪位著名印度大诗人的诗集	在《十八岁的天空》中有“世界上最遥远的距离不是生与死,而是我站在你面前,你却不知道我爱你
与父亲王羲之并称“二王”的书法家是谁	王献之
《封神演义》中，哪吒的父亲托塔李天王名叫什么	李靖
多瑙河在哪里	多瑙河在欧洲仅次于伏尔加河,是欧洲第二长河
与我国的云南省接壤的国家分别是缅甸、老挝和哪个国家	越南 缅甸、老挝
齐达内在哪些年获得过世界足球先生	获得过3次,98年,2000年和2003年!齐达内个人荣誉:1996年95/96赛季法国足球先生1998年世界杯金球奖1999年国际足联1998年世界足球先生2000年国际足联2000年
由台北市立棒球场发建，众艺人在台北开演唱会的首选场馆叫什么	小巨蛋
诸葛亮的“诸”字，添上一个“单人旁”应该念什么	谡 速音 诸葛亮用马谡,马谡言大才疏,失了街亭,不得不在南城这个小城使用空城计,吓退司马懿的几十万雄兵
东北林大的邮编是多少	100040
愚人节是每年的几号	4.1
电影《碟中谍》男主角的扮演者叫什么名字	汤姆克鲁斯
唐代诗人王维的《送元二使安西》中“劝君更尽一杯酒”的下一句是什么	渭城朝雨浥轻尘,客舍青青柳色新
每年举办的台湾规模最大的音乐奖项是	金曲奖
获得第五十九届奥斯卡最佳原著剧本奖，执导《汉娜姐妹》的鬼才导演是谁	伍迪艾伦
科学家道尔顿最初因为选错哪种穿着用品的颜色而发现了色盲这一现象	樱桃红色的袜子 在一个圣诞节前夕,道尔顿给他的妈妈买了一双“棕灰色”的袜了做为圣诞节的礼物
“迪斯尼”的总部设在哪个国家	美国.. . Amecera
普法战争结束后，法国被迫割让的是阿尔蒴斯和哪个地区	洛林
“火烧面部的哪个部位”来形容事态的着急	眉毛
形容学问广博，无所不知，我们通常会说：“上知天文”的下半句是什么	下知地理
算盘横有一梁，将算盘分为上下两部分，梁上一珠代表几	5
“五十六个民族五十六支花，五十六族兄弟姐妹是一家”这是由宋祖英演唱的哪首歌	歌词“五十六个民族五十六朵花“的歌曲名是《爱我中华》
中国唯一以花命名的城市是四川省的哪座城市	攀枝花市是全国唯一一座以花命名的城
地球上男人占多大比重	给你资料看看! 目前全世界的性别比例非常接近于1:1,但具体到各个国家,则差别很大
法国前总统萨科奇的妻子是哪位名模	卡拉·布吕
奔驰汽车原产于哪个国家	德国 梅赛德斯-奔驰
《Yesterdayoncemore》是哪个美国著名兄弟组合的歌	卡朋特
近期上映的由威尔.史密斯和汤米.李.琼斯主演的电影叫什么	黑衣人3
苏联的全称是什么	前苏联的全称苏维埃社会主义共和国联盟(俄语:СоюзСоветскихСоциалистическихРеспублик,简称СССР;
张爱玲的名著《金锁记》中，女主角叫什么名字	曹七巧
我国第五套人民币中一百元纸币的水印图案是哪位领袖人物	 毛泽东
“收获颇丰”中的“颇”字是什么意思	颇,这个字无论在文言文还是现代文中,意思大多都是很的意思
《笑傲江湖》中被华山掌门岳不群逐出师门的大师兄叫什么	令狐冲
WPS是由哪个公司开发的	金山公司
“小玉，花轮，美环”是哪部日本动画片中的角色	樱桃小丸子
山东山西的山指什么	山西的山是指太行山,山西东为太行,西为吕梁
西方的万圣节，人们会用什么植物做成一盏灯	在西方国家,每年的10月31日,有个“Halloween”,辞典解释为“The eve of All Saints'Day”,中文译作:“万圣节之夜”
俗话“读书百遍”下一句是什么	其义自见
出自杜牧诗中“东风不与周郎便”的下一句是	铜雀春深锁二乔
“人间四月芳菲尽，山寺桃花始盛开”是唐朝哪位诗人的诗句	白居易 的诗句
因多次发生战争被称为“欧洲火药桶”的是哪个半岛	巴尔干半岛
发生“财政赤字”时，会计核算会用什么颜色的子来标注处理	红色 标注处理
故宫乾清宫上的牌匾“正大光明”四字最早是由哪位清代皇帝所书	顺治
位于安徽省的凤阳县是哪位明朝皇帝的故乡	朱元璋(1328年-1398年),字国瑞
和中国足协签署价值至少5亿元三年合约的大连万达老板是谁	万达老板是王健林 满意就请采纳
隋朝郡主的姓氏是什么	姓杨,大隋共传位三代天子: 大隋高祖文皇帝杨坚、大隋世祖明皇帝杨广、大隋世宗恭皇帝杨侑
ftp的中文全称是什么	Telnet-------------------- TELNET协议的目的是提供一个相对通用的,双向的,面向八位字节的通信机制
中国历史上第一枚奥运金牌是在哪个项目上获得的	射击 上获得的
叙利亚的现任总统是谁	巴沙尔·阿萨德(BasharAl-Assad)2000年6月10日,老阿萨德在于1971年自封总统,执掌国家29年后猝死,作为次子的巴沙尔·阿萨德与一个月后的7月10日继任总
自然数的变化范围是多大	你没图,是我猜的
西红柿还有什么别的名字	番茄也可以称 love apple 但是几乎没有人会这么称番茄的
世界上最大的海湾是亚洲的哪个湾	1、世界上最大的海湾是 ;世界上最大的半岛是 .2、在世界大洲中,跨纬度最大的是(　　)A.大洋洲 B.欧洲 C.南极洲 D.亚洲3、苏伊士运河沟通的是
牛郎星位于哪个星座	牛郎星和织女星是两颗象太阳那样的恒星，它们也是能够自己发光发热的
自古以来有“塞上明珠”称号的宁夏回族自治区首府是哪座城市	银川
火星有几颗卫星	火星有两颗天然卫星.1877年由美国的A.霍尔发现.火卫一离火星中心9370千米,公转周期为7小时59分,比火星自转快得多,所以从火星上看来,它是西升东落的
俗话说：“皇帝不急急死什么人”	古代皇宫里的规矩还是很多的
出自岑参《白雪歌送武判归京》中，“北风卷地白草折”的下一句是什么	胡天八月即飞雪
飞流直下三千尺，疑是银河落九天，描写的是哪座山的景色	庐山的景色
“我愿变成童话里你爱的那个天使”这句歌词出自哪位男歌手的原唱歌曲《童话》	歌名:童话 歌手:光良 忘了有多久再没听到你 对我说你最爱的故事 我想了很久我开始慌了 是不是我又做错了什么 你哭着对我说童话里都是骗人的 我
战国四公子中，因有三千门客而闻名的是哪位	孟尝君田文
我国自主研制并发射的首个月球探测器叫什么名字	嫦娥一号卫
世界上已知的金属中密度最小最轻的是什么	密度最小的金属是锂,密度是0.54 g/cm3
当我们说一台电脑是“486”或“586”时，这实际上是指的是电脑的哪个部件	中央处理器 1
历史上“焚书坑儒”的只中国的那一位皇帝	秦始皇``````````````````
被看作西藏人的护卫犬和保护神，并有东方神犬称号的是什么	称号的是 藏獒
孙燕姿曾就读的南洋理工大学位于哪个国家	新加坡
哪位台湾男歌手和桂纶镁合作，自导自演了电影《不能说的秘密》	周杰伦
汉武帝第二任皇后，卫青的同母异父姐姐是谁	卫子夫
世界上最大的黄金生产和出口国，是位于非洲的哪个国家	铜产量是赞比亚, 铝土矿是几内亚,居世界首位
经典电视剧《新白娘子传奇》中，饰演小青的是哪位著名女演员	陈美琪
安南是哪个国家的人	是南非的 还有中国的陈健是联合国副秘书长 安南是生于加纳 但他的国籍是南非
我们常用哪种动物的腿来形容女生的腿又粗又壮	大象
有“小甜甜”外号的美国流行天后叫什么名字	流行天后 布莱
歇后语“小葱拌豆腐”的下句是什么	小葱拌豆腐,一清二白
主演了电影《当幸福来敲门》《我是传奇》的好莱坞影星是谁	威尔·史密斯(Will Smith,1968年9月25日-)美国演员、歌手,出生于美国宾夕法尼亚州费城
著名的“自由女神”像坐落在美国的哪座城市	纽约
满汉全席始于清朝哪位皇帝在位时期	乾隆
由西晋陈寿编写的记载魏、蜀、吴鼎力时期的“纪传体国别史”叫什么	《三国志》
人可以躺在上面而不沉下去的全世界海拔最低的琥珀是哪里	死海
“池塘边的榕树上，知了在声声叫着夏天”是罗大佑的哪首经典歌曲	《童年》
著名的“埃菲尔铁塔”是哪个城市的标志性景点	巴黎
哪个星球有生物	现在太阳系中可能存在生命的是：火星和土卫六－－泰坦
李白的诗句“欲渡黄河冰塞川”的下一句	将登太行雪满山
《文化苦旅》是哪个作家的第一本散文集	余秋雨
香港演员谢霆锋的大儿子叫什么	Lucas
MPEG是什么的缩写	MPEG(动态图像专家组)是MovingPictureExpertsGroup的简称
“什么干，什么干，我打开任督二脉”是周杰伦演唱的哪首经典歌曲	周杰伦演唱的 双截棍
阿尔及利亚用什么货币	非洲阿尔及利亚用的货币是——第纳尔阿尔及利亚第纳尔为阿尔及利亚官方货币
收看奥运会时，字幕显示“volleyball”的是哪项体育比赛	排球 体育比赛
种子植物依据种子外面有无果皮包被可分为被子植物和什么植物	种子植物对陆地的适应能力很强,依据种子外面有无果皮包被可分为被子植物(有果皮)和裸子植物(无果皮 谢谢采纳
宋之问的《渡汉江》中，“近乡情更怯”的下句是什么	不敢问来人
我国四大油料作物是花生、大都、芝麻和什么	油菜和大豆、花生、芝麻并称为我国四大油料作物
《神雕侠侣》中，杨过在全镇教学武拜的师傅是谁	赵志敬
大陆与台湾在1993年进行了第一次“汪辜会谈”，其中“汪”指的是	汪道涵
俗语“以其人之道”的后半句是什么	还治其人之身
世界上最大的淡水湖是哪个湖泊	世界上最大的淡水湖应该是“贝加尔湖”
1945年哪位当时的副总统接替因病去世的罗斯福担任美国总统	杜鲁门 担任美国总
被称为“液体面包”的是哪种酒	啤酒
在我们常说的Q版人物中，“Q”指的是什么意思	单片机是指一个集成在一块芯片上的完整计算机系
《神雕侠侣》里砍断杨过手臂的郭芙蓉最后嫁给了谁	耶律齐
美国哪个城市被称为太平洋女王	旧金山或称“圣弗朗西斯科”、“三藩市”
俗话说“林子大了”的下一句是	就是说,现在的社会各种各样的人都要,只是你想不到
电脑中央处理器的英文缩写是哪三个字母	CPU
艾弗森上的是哪所大学	毕业于美国的乔治城大学,主修美术专业. 呵呵
战国时期，秦国在统一中国的过程中最先消灭的是哪个诸侯国	韩国
小说《封神演义》中，传说由狐狸精变成的商纣王宠妃是谁	苏妲己
印度的母语是什么	印度民族众多,语言复杂,印度共有1652种语言和方
古代文学理论著作《文心雕龙》是哪位南朝文学理论家的著作	刘勰
奥运会闭幕于哪天	开幕式 时间：2008年08月08日 星期五
康熙时期，中国与哪个国家签订了《尼布楚条约》	康熙时期,中国与俄国签订了《尼布楚条约》
形容自己给自己招惹大麻烦，常说是“捅了哪种昆虫的窝”	马
2006年德国世界杯的专用球叫什么	2006年德国世界杯的比赛用球叫“团队之星”
柳永、李清照都是宋词中哪个流派的词人	婉约派 的词人
“咆哮帝”是网友对哪位台湾男演员的戏称	马景涛
著名女子运动员叶乔波曾经是我国哪个运动项目的运动员	速滑/短道速滑
亚洲第一高楼是台北的什么楼	正在申请使用执照的台北一0一大楼，2004年十月八日正式被世界高楼协会(CTBUH)颁予“世界第一高楼”证书，获得“世界最高建筑物”、“世界
哪位男歌手跟韦唯合唱了《亚洲雄风》作为北京亚运会歌曲	刘欢
八旗制度在初建时设的四旗是	　　明朝万历二十九年(1601)建立 黄、白、红、蓝 四旗,称为正黄、正白、正红、正蓝,旗皆纯色
我国著名的“沙县小吃”是我国哪个省的美食系列	我国菜系有三种划分方法:按省按划分四大菜系有2种说法...其中最有名的是沙县小吃
世界上面积最小的大陆是哪个大陆	面积最小的是澳大利亚大陆,最大的是欧亚大陆,望采纳,谢谢
土耳其的首都在哪个城市	安卡拉呀,经济中心在伊斯坦布尔
据说牛顿是看到哪种水果下落受到启发从而发现了万有引力定律	苹果
《莫靡靡之音》是天后王菲为了纪念她的哪位偶像而出版的翻唱专辑	邓丽君
周迅的前任男朋友，是哪位台湾著名造型师	李大齐
“砍头不要紧，只要主义真”是哪位革命先驱临刑前写的就义诗	这是革命烈士夏明翰临刑前所写的《就义诗》
1885年哪位德国汽车制造商制造出第一辆摩托车	1885年德国汽车制造商戈特利伯·戴姆勒制造出第一辆摩托车
红海是哪块大陆的	红海之前是没有的.后面地震形成的.非洲板块和印度洋板块张裂形成
在神话故事《西游记》中，托塔天王的全名是什么	李靖
在古罗马神话中，掌管爱与美的女神是	维纳斯
查看中国的地图图例符号时，图形为“红色五角星”的代表什么意思	首都
人体心脏所有的心房和心室加起来总共有几个腔室	4 个
尼日尔河位于哪里	尼日尔河 Niger，River 非洲第三长河
英国历史上唯一一位被公开处死的国王是谁	查理一世////
我们常说一个东西值5刀，请问“刀”是哪种货币的别称	美元
长途电话多少钱一分钟	0
秦始皇统一中国是在什么时候	公元前221年,秦始皇统一中国
《三国演义》中刘备手下的五虎将之一，以老当益壮、百步穿杨着称的是谁	以老当益壮、百步穿杨著称的是 黄忠
飞机专用电子设备之一的“黑匣子”是什么颜色的	(1)黑匣子被火烧30分钟,温度升至1100℃,其内部磁带也不会被烧毁,是因为它具有抗压、抗高温等特殊结构.(2)需承受的海
出自李白的《将进酒》，“天生我材必有用”的下一句是什么	千金散尽还复来
在波音公司生产的民用客机都会用哪个数字开头	7
名著《水浒传》中，绰号“玉麒麟”的人叫什么名字	卢俊义
相传战国时齐国丑女，四十岁不得出嫁，后被齐宣王立为王后的是谁	无盐,姓钟离,名春,钟离春
俗话说“看事容易”的下一句是	做事难,肯定是的喽
“口蜜腹剑”指的是唐玄宗时期哪个宰相的恶名	李林甫 的恶名
面包沙司由什么水果制成	沙司是英语Sauce的译音,已为大家熟悉和常用,是一种用蔬菜或水果加调味品制成的流质或半流质酱汁
“仲夏”通常被我们用来形容农历几月份	五月
Ph.D是对哪种学位的英语简称	--------------------------------------------- 金山电子词典的解释是这样的： Philosophy Doctor 的缩写
火警的号码是多少	911
封建社会皇帝下的命令或发表的言论的文书叫什么	圣旨.....圣旨
高速公路上行驶的机动画遇到能见度小于50米的大雾，最高时速不能超过多少公里	20
唐代诗人崔颢《黄鹤楼》中，“晴川历历汉阳树”的下一句	芳草萋萋鹦鹉洲
西安的区号是什么	不知道你要西安什么位置的邮编,下面是西安邮政编码详表,你可以在这里面查找你所需位置的邮编
哪种金属的氯化物不溶于水	这句话不完全对PbF2微溶,PbCl2也是微溶的(暂时就找到一个特例)PbF2 Ksp=4.0×10-8PbCl2 Ksp=1.6×10-5(都是微溶)氟化物特殊性:典型的离子型氟化
世界上最大的岛屿是哪个岛	格陵兰岛是世界上最大的岛屿，面积达2
韩国的总统官邸是位于首尔的哪座建筑物	青瓦台
中国最长的河流是什么河	长江(Changjiang River),亚洲第一大河,其流域面积、长度、水量都占亚洲第一位
中国象棋中，哪个棋子只能隔着一个棋子吃子	一.棋盘和棋子 1.棋盘 象棋盘由九道直线和十道横线交叉组成
世界上物种最丰富的湖是哪个	最大的淡水湖是贝加尔湖,咸水湖是里海
著名影星成龙为保护野生动物的公益广告词中“没有买卖”的下一句是	就没有杀戮
杜牧的《赤壁》中“东风不与周郎便”，周郎指的就是哪位三国名将	赤壁之战 周瑜、曹操
出自《孟子》，“尽信书”的下一句是什么	孟子说出“尽信书则不如无书”这句话的时候,是因为对《尚书》中关于武王伐纣的情形产生了怀疑
行车过程中紧急刹车时，人体向前倾是由于什么物理现象	惯性,由于惯性人保持向前的运动状态,车静止,人体向前倾
成语“乐不思蜀”最初是指三国时期的谁不思复国	指蜀后主刘禅
《水浒传》中冒充黑旋风李逵拦路抢劫，后被李逵遇见并杀死的人是谁	常冒充李逵拦路打劫,有一次正好撞上真李逵,被李逵一刀打翻在地
二十四节气是什么	夏至和立夏不是一个意思 二十四节气起源于黄河流
苏轼《水调歌头》，“起舞弄清影”的下一句	何似在人间
全球最大的连锁超市叫什么	沃尔玛
有“东方太阳城”美誉的是山东省的哪一座新兴港口城市	日照
贵州省的省会是哪座城市	贵阳
年作为央视春节联欢晚会结尾曲的歌曲叫什么名字	难忘今宵 难忘今宵
我国东北地区有“共和国钢都”之称的是辽宁省的哪座城市	鞍山
哪个影集销量最好	http://www.cr173.com/soft/35345.html 简单易用 这个好像功能
运动员为了提高成绩而违法服用的禁药统称为什么	兴奋
《祝你一路顺风》是哪位台湾歌手的作品	吴奇隆
2001版电视剧《康熙王朝》中，饰演成年康熙皇帝的是我国哪位著名男演员	陈道明
杜成义是哪位新加坡男歌手的原名	阿杜
欧洲的哪座城市举行了世界气候变化大会	很有名的城市哥本哈根
首位登上美国奥斯卡金像奖颁奖典礼献唱的华语歌手是哪一位	李玟 / Coco
王心凌歌曲《睫毛弯弯》中“睫毛弯弯”的下一句是什么	眼睛眨呀眨
普通白炽灯的发光光强是多大	发光原理: PN结的端电压构成一定势垒,当加正向偏置电压时势垒下降,P区和N区的多数载流子向对方扩散
着有《小时代》《悲伤逆流成河》等作品的“80后”作家是谁	郭敬明
我们平时所说的“北电”是我国那个电影类专业艺术院校的简称	北京电影学院
我国长江流域和黄河流域的分水岭是什么	秦岭
以其独特的雪景而著名的日本最北边的岛屿是哪个	北海道
我们通常把紧急抢救时嘴对嘴吹气的急救方式称为什么	人工呼吸
每次射精会有多少精子	一组男性正常性生理数据
电视剧《上海滩》，冯程程的父亲，上海青帮最大头目叫什么	冯敬尧
五线谱中表示降半音是用哪个小写字母表示	首先,搞懂升号是#,降号是.哪个音需要升半音就在那个音符前面加个#,哪个音需要降半音就在那个音符前面加个&#9
我们说的“小电驴”指的是哪种常见交通工具	电瓶车
有“咖啡王国”之称的是南美洲的哪个国家	巴西
俗语说“酒香不怕什么深”	说实话,在这什么都是“速成”的时代是行不通,就算酒香不怕巷子深,可是要让酒挥发出香味也是需要时间的
电影《盗梦空间》中，莱昂纳多饰演的主角用来分辨真实与梦境的道具是什么	陀螺
电视剧《风云》中，何润东扮演的是步惊云，那么聂风是由谁扮演的	赵文卓
被称为“钢琴之王”的是匈牙利哪位音乐家	A 著名的匈牙利作曲家、钢琴家、指挥家,伟大的浪漫主义大师,是浪漫主义前期最杰出的代表人物之
俄罗斯著名运动员伊辛巴耶娃是哪个项目的杰出运动员	俄罗斯著名运动员伊辛巴耶娃是撑杆跳高项目的杰出运动员
户枢不蠹的不蠹是什么意思	蠹是蠹虫. ,是古代专咬器具的虫子. 不蠹就是不会被蠹虫咬,不生虫,不会腐烂的意思
王昌龄的古诗“但使龙城飞将在”的下一句是什么	这是唐代王昌龄的一首七言绝句. 出塞 【唐】 王昌龄 秦时明月汉时关, 万里长征人未还. 但使龙城飞将在, 不教胡马度阴山.赏析:这是一首著名的边塞
你去年又是多大年纪	Just as usual, my parents and I would enjoy a traditional Chinese Spring Festival this winter holiday. We would go visit our relatives and
西部电影中常出现的单词“cowboy”是什么意思	Western cowboy cowboy ( cowboy ) is introduced, and the Americans called cowboy. We for a cowboy ( West Cowboy ) understanding, are mostly
瑞星杀毒软件的标志是什么动物	瑞星杀毒软件的标志,是一只雄狮子的头部特写,鬃毛扩散呈盾牌状
俗话说“普天之下”的下一句是什么	莫非王土
“孔融让梨”出自中国哪部国学启蒙读物	三字经
《倚天屠龙记》中，倚天剑和屠龙刀的铸造者是哪对夫妇	郭靖和黄蓉
地壳中含量最多的元素是什么元素	氧、硅、铝、铁、钙含量前五位.这个要记住的
俗话说“有则改之”的下一句是	吃一堑"的下一句是(长一智 ) "有则改之"的下一句是(无则加勉 )
比尔.盖茨的房子有多少平方英尺	66000
与淘宝整合在一起，买家与卖家沟通的聊天软件是什么	阿里旺旺
金庸小说中的“降龙十八掌”的最后一招是什么	我博客里写过这个专题.详细看 降龙十八掌，至刚至阳，刚猛无双；一招亢龙有悔，退无可退，让无可让，震惊百
伽利略做“自由落体实验”的比萨斜塔位于欧洲的哪个欧洲国家	意大利
吃富含哪种维生素的食物有延缓衰老，是皮肤保持白皙的功效	维生素E
杜牧的《过华清宫绝句》一骑红尘妃子笑的下一句是	无人知是荔枝来
NBA总决赛采用几战几胜的赛制	2015nba总决赛采用2-2-1-1-1赛制
陆地地形分为五大类，有山地、丘陵、高原、平原和什么	陆地表面的地形多种多样,人们通常把陆地地形分为平原、高原、山地、丘陵和盆地五种基本类型
赵云的“赵”字在繁体字中，是“走”字边加上一个什么字组成	肖 肖
如果让你来解决你会采取哪些措施	如何使外来人口融入当地社会的工作及生活圈,使其安居乐业,始终是一个世界性的难题
我们通常用哪两个英文字母表示数码摄像机	DV 表示数码摄像机
佛教中的十恶最后一恶是什么	一、杀 杀谓杀害生命
北京都有什么主要的景点	以天安门广场为主线,游览天安门城楼,参观人民英雄纪念碑、毛泽东纪念堂、人民大会堂、历史博物馆、故宫、中山公园、景山公园、北海公园
卧龙先生是谁	诸葛亮
名句“山外青山楼外楼，西湖歌舞几时休”讽刺的是哪个朝代的统治者	南宋 南宋
疯牛病最早出现在哪个国家的牛身上	英国 的牛身上
2010—2011欧洲冠军联赛花落谁家	巴塞罗那
1978年在安徽哪个村实施的“包产到户”制拉开了改革开放的序幕	小岗村 第二轮 于文汇PK王鹏杰
奥斯陆是哪个欧洲国家的首都	奥斯陆,是挪威的首都和最大城
在海子的诗中，“从明天起，做一个幸福的人”指的是“喂马，劈柴”和什么	《面朝大海,春暖花开 》 文/海子 从明天起,做一个幸福的人 喂马,劈柴,周游世界 从明天起,关心粮食和蔬菜 我有一所房子,面朝大海,春暖花开 从明天
上海证券交易所股票交易所大厅的交易员会穿什么颜色的马甲	红马甲是指证券交易所内的证券交易员,因穿红色背心而得名
法国在2002年欧元发行之前的使用的法定货币的单位是什么	单位是 法郎
歌曲《闪闪惹人爱》收录于萧亚轩的哪一张专辑	《钻石糖》
经典名歌《乌苏里船歌》中唱到的乌苏里江，是中国和哪个国家的界河	俄罗斯
通常家用电器上“off”表示的是什么意思	on,开通的意思,off,关闭的意思,但在断路器上就是反向的,你可以逆向理解的,主要看用在哪
商店中碰到这样的符号“$”，表示要用什么币种付款	美元
张柏芝于2001年第一次公开的圈内男朋友是哪位香港偶像男歌手	陈晓东
因长期间对刘翔进行跟踪采访而被大家熟知的蒙古族体育记者是谁	冬日娜
泰格伍兹是四大绅士运动中哪一类的著名运动员	高尔夫球
白居易的《暮江吟》中，“可怜九月初三夜”的下一句是什么	露似珍珠月似弓
白血病可以通过移植身体内的什么组织来治疗	骨髓
白炽灯用久了为什么会发黑	灯泡使用时,钨丝在高温下升华为钨蒸气,关灯后,温度降低,钨蒸气凝华为粉末状的细小钨颗粒附着凝结在灯泡壁上,时间长久就会变黑
《史记.高祖本纪》中说道，“运筹帷幄之中”的下一句是什么	决胜千里之外
乐器唢呐上有几个孔	唢呐又名喇叭，小唢呐又称海笛
诸葛亮隐居隆中时，常自比管仲和哪位历史人物	乐毅
刚生完孩子的产妇腹壁上的皱纹被称为什么	妊娠纹
这个三角形面积大概能有多少	12
未来几年的交通工具会是什么样子	地铁和公交车为主,要是往空中发展的话空间不够,全球人口太多,而且控制困难,能源也是一大难题,停车位就不
鸟以多快的速度飞行	蜂鸟的飞行本领高超,可以倒退飞行,垂直起落,甚至可以在空中静止4~5分
世界上最重要的IT高科技产业基地硅谷位于美国的那个州	加利弗尼亚州
《新婚别》《无家别》《垂老别》是哪位唐代诗人的经典作品	杜甫
记载中“以舟为梁”，其“梁”可以认为是古代桥梁的雏形吗	建造船来搭成浮桥,不也能显示他的荣耀吗
经典港剧《义不容情》的主题歌是已故歌手陈百强演唱的那首歌	《一生何求》
通常英语缩写“Jul”代表的是几月份	七月
清朝在位皇帝顺序中，康熙前一位皇帝是谁	前一位皇帝是 顺治
世界名著《傲慢与偏见》的作者是哪位英国作家	简·奥斯丁
国际红十字会旗帜是什么形状	正方形
《战争与和平》是俄国哪位作家的著作	列夫托尔斯泰(ЛевНиколаевичТолстой) 他有作品:<<复活>> 《战争与和平》 等
“六畜兴旺”中的“六畜”是指猪、牛、马、羊和另外哪两种动物	狗鸡
五脏六腑的五脏是指什么哪五脏	中医学根据五脏在人体中的不同作用和特性，将五脏和五行一一对应，发展出了中医五行学说
电视剧《武林外传》中“李大嘴”使从事什么职业的角色	厨师
小说《钢铁是怎样炼成的》中，林务官的女儿，保尔的初恋情人是哪个女孩	在河边吧,我只知道保尔是在钓鱼时认识了她
相传秦始皇因为渴望长生不老，派谁出海寻找仙药，却最终一去不返	徐福
黄山在我国什么省份	黄山在哪个省份?黄山大概是横跨了三个省吧
打足了气的自行车胎在烈日下容易爆胎是因为哪种物理现象	热胀冷缩
凹凸的“凸”字是多少笔画	两个字笔画数都是五画
夫子庙始建于宋，位于什么河北岸的贡院街旁	秦淮河
毛主席的名句“谁敢横刀立马，唯我彭大将军！”中的彭大将军指的是谁	彭德
江西省的简称是因为哪条江而得名	赣江
中国四大发明中的造纸术是由东汉哪位著名人物改进的	蔡伦
日本动漫《圣斗士星矢》中，青铜五战士中的一辉的弟弟叫什么名字	一辉的弟弟叫 阿顺
上海座机区号加上电话号码一共是多少位	11
电影《康熙王朝》中，康熙的饰演者是哪位男演员	陈道明
树上春树的哪一本春天恋爱小说，与披头士一首逸闻世界的歌曲同名	挪威的森林
理性纯洁的精神恋爱又被人们称为哪位哲学家式的爱情	柏拉图
成语“送君千里”的下一句是	终须一别
第一次世界大战是什么时候爆发的	第一次世界大战爆发的时间是1914年6月28日
经典电影《菊次郎的夏天》由哪位日本明显自编自导自演的	北野武
世界短跑名将尤赛恩.博尔特是哪国人	牙买加啦
能使淀粉变成蓝黑色的是什么	碘.高温可以使络合物分解，但温度要足够高才
云南著名的西双版纳是哪个少数民族的聚居区	傣族 的聚居区
草蜢乐队的经典歌曲《失恋阵线联盟》是20世纪90年代哪部台湾经典电视剧的主题曲	是《家有仙妻》
《少年游》《心太软》是哪位男歌手的代表作	?任贤齐
每天工作中最烦的事情有哪些	态度问题,工作心态不好,对人或是工作有抵触
香港演员徐濠萦是哪位香港歌手的妻子	陈奕迅
唐朝时高僧鉴真六次出访传播佛教的对象是如今的哪个国家	日本
香港演员利智是哪位华人功夫巨星的妻子	李连杰
接吻时你觉得对方的口水是什么味道	刚吃过东西会有味道,对方身体状况不好的话会有点臭,如果一切都好且没有口臭的毛病,会是有一丝甜甜的味道,很舒服的
80年代电视剧《霍元甲》主题曲叫什么	本来的电视剧名和歌名就叫《大侠霍元甲》,现在香港依然用这个剧名和歌名,香港丽的电视台(现在的“亚视”)1981年制作
马拉松长跑全程有多远	马拉松(Marathon)长跑是国际上非常普及的长跑比赛项目,全程距离26英里385码,折合为42.195公里(也有说法为42.193公里).分全程马拉松(Full Marathon),半程
被称为“老爹”的台湾著名摇滚歌手是谁	迪克牛仔
茶叶依发酵程度不同分为三种，分别是绿茶、乌龙茶和什么茶	绿茶.乌龙茶 红茶
我们用哪种动物比喻代人受过替人顶罪的人	羊
七言古诗《茅屋为秋风所破》是唐代哪位诗人的作品	杜甫
儿歌“小兔子乖乖，把门开开”是什么动物唱给兔子听的	小兔子乖乖,把门开
《新婚别》《无家别》《垂老别》是哪位唐代诗人的经典作品	杜甫
科学家普利斯特里是哪国人	英国人
法语Bonjour翻译成中文是什么	您好,请出示您的证件
一个是阆苑仙葩，一个是美玉无瑕，是出自哪部著名电视剧的主题歌	红楼梦
古语“吾十有五而志于学，三十而立，四十而什么”	不惑
南岳衡山的最高峰是什么峰	“南岳四绝”之祝融峰之高
在对口相声中，两人各有分工，一位捧眼，另一位是	A逗
哪部小说有小龙女这个人物	神雕侠侣^_^
祁连山是哪两个省的分界线	青海与甘肃 1
清朝时期，科举殿试的第二名叫榜眼，那么第一名叫什么	奥是状元了
物质从固态直接变为气态的物理变化叫什么	物理变化叫升华
《神雕侠侣》中，郭芙的丈夫是哪一位	耶律齐......耶律齐
日本人平均寿命是多大	79-86
《神雕侠侣》中，杨过中了情花之毒后因吃了什么草而解毒	断肠草 而解毒
台湾资深配音演员，周星驰的御用配音演员艺名是	石班瑜为台湾男性资深配音演员,本名石仁茂,绰号石斑
伽利略做“自由落体实验”的比萨斜塔位于欧洲的哪个欧洲国家	意大利
我国先秦第一部富于神话传说的“最古老的地理书”叫什么	我国第一部最早的神话故事集叫《山海经》
成语“明修栈道”下一句是什么	暗度陈仓
一个长方体长是2米，宽是1米，高2米，那么它的体积是多少立方米	5
比利牛斯山是西班牙和哪个欧洲国家的天然分界线	法国 法国
传说陈阿娇托司马相如写了一篇什么文字来感动汉武帝	长门赋
电视剧《风云》中，何润东扮演的是步惊云，那么聂风是由谁扮演的	赵文卓
京剧《群英会》中“周瑜”属于哪一个传统戏曲角色行当	小
卢沟桥上的“卢沟晓月”石碑是清朝哪位皇帝题写的	 乾隆
在三人斗地主扑克游戏中，“火箭”是指哪两张牌	地主抓到第一张王的概率=20/54,抓到第二张王的概率=19/53,所以抓火箭概率=20/54*19/53约=0.133.跟抓王的顺序无关,跟王其实也没有关系,因为
树上春树的哪一本春天恋爱小说，与披头士一首逸闻世界的歌曲同名	挪威的森林
“阿诗玛”是哪个省的少数民族塑造的艺术形象	云南
武术冠军出身，以出演黄飞鸿、方世玉等角色为国人所熟知的武打明星是谁	武术冠军出身,以出演黄飞鸿、方世玉等角色为国人所熟知的武打明星是谁?李连杰
中国古代“九州岛”中的豫州，后简称为“豫”的是哪个省	河南
火山湖有多深	世界上火山最多的国家是印度尼西亚
中国最长的运河是哪一条	以上的回答都是错误的，古代世界最长的运河是我国隋朝的大运河
历史上哪个不平等条约强迫我国割让了香港岛	1840年英国发动鸦片战争,强迫清政府于1842年签订《南京条约》,割让香港岛
哪个城市被称为“国际会议之都”	日内瓦是国际名城,瑞士日内瓦州首府
、在掷骰子游戏中，使用单个骰子的最大的点数为几点	骰子游戏基本规则简单明了
因2000年欧洲杯时贝克汉姆留的发型而闻名的“鸡冠头”又叫什么发型	莫西干
我们把女性好友称为“红颜知己”，相对应的男性好友被称为什么	蓝颜知己
食盐的主要化学成分为什么	先用酸.MgO + 2H+ == Mg2+ + H2OFe2O3 + 6H+ == 2Fe3+ + 3H2O充分反应后过滤掉SiO2然后利用水解来除去Fe3+(Fe3+在pH=3时就开始沉
80年代的歌曲，歌中唱到“我家住在什么地方，大风从坡上刮过”	解答:解:黄土高坡指我国的黄土高原.在黄土高原地区,人们依据黄土的直立性质,挖掘了冬暖夏凉的窑洞来居住.故选:D
《有的人》是哪一位当代诗人为纪念鲁迅逝世十三周年而写的一首抒情诗	臧克家
导演张艺谋的出生地在哪个中国西北大省	陕西
“扶桑”指现在哪个与我国隔海相望的国家	扶桑是中国名花,在华南栽培很为普遍
名气仅次于灞桥的中国名桥是哪座桥	长江上最新的一座桥，名叫润扬长江大桥，连接江苏省的镇江（古称润州）与扬州
台湾歌手张宇的老婆，《月亮惹的祸》《用心良苦》的词作者是谁	十一郎,原名萧慧文,词作者,台湾人
考试之前紧张睡不着觉该怎么办	放松一点,别太想着他,我以前也有过,叫做强迫症,其实他也不是病,就是紧张,明明这东西放了可觉得没放,最好的就是别想它,找个人帮你安慰一下,没事
被誉为“世界最美丽的大街”法国香榭丽舍大街两旁种的是什么树	?梧桐树
巴西都在哪些年获得过世界杯冠军	5次
炸酱面、豆汁、炒肝是我国哪个城市的风味小吃	北京
世界上第一枚邮票出现在哪个国家	世界第一枚邮票黑便士  世界上第1枚邮票，1840年5月1日在英国问世， 5月6日开始使用
我们常把“不会游泳的人”被称为“什么鸭子”	鸭子本来喜欢水,你不让它进水,急得出汗了,人也是
辅佐齐桓公成为春秋时期的第一霸主的人是谁	周文王任用( 姜尚),在他的辅佐下国家强盛起来;齐桓公捐弃前嫌,任用(管仲 )为相,在他帮助下成为春秋时期的第一个霸主
王维的《山居秋暝》中，“明月松间照”的下一句是什么	很明显,“王孙自可留”中的王孙是作者“不欲仕宦之意”的真实写照
冯小刚执导的电影《天下无贼》，插曲《知道不知道》是由哪位台湾女歌手演唱的	刘若英 演唱的
我国企业对所售商品实行的“三包政策”指的是“包修”、“包换”和什么	 包
发射第一颗人造卫星的是哪个国家	1957年10月4日，苏联宣布成功地把世界上第一颗绕地球运行的人造卫星送入轨道
CPR的意思是什么	cpr 心肺复苏术-CPR ( CARDIOPULMONARY RESUSCITATION ) 心肺复苏术(CPR)是现场急救的技术,如果在患者倒地后四分钟之内进行CPR ;八分钟内做高级心脏救护
2012年11月27日，我国上证综指跌破多少点的大关，正式进入"1"时代	2000
梁羽生小说《云海玉弓缘》中少年时就被世人遗弃的男主人公叫什么名字	金世遗 梁羽生武侠小说《云海玉弓缘》中的人物,绰号「毒手疯丐」,行踪所至,群丑慑伏,邙山一战,令清宫侍卫不敢再行走江湖
第五套人民币背面主图为桂林山水图案票面是多少元	票面是 二十元
温哥华是哪个国家的城市	温哥华是加拿大的一个城市,但不是首都
旧称“北平”是现在中国的哪座城市	北京
成语“鹣鲽情深”的鲽是哪种眼睛长在同边的鱼类	 比目
三角函数中sin表示正弦，请问cos表示什么	余弦
中国第一个海上油田“埕北油田”位于我国什么海的西南方	渤海
人们一般所说的“孔方兄”是对哪种物品的调侃式的称呼	钱
哪座古城曾因为在三次布匿战争中均被罗马打败而灭亡	 迦太基 2
有“小甜甜”外号的美国流行天后叫什么名字	流行天后 布莱
螃蟹的血液是浅蓝色的，因为其中含有哪种金属微量元素	铜 微量元素
新中国首位外交部长是谁	陈毅
我们吃的椰子大部分产于我国哪个省	海南/
哪一届中国政府收回了香港	香港是1842年根据《中英南京条约》割给英国
海洋中的“乌贼”又被称为什么鱼	墨鱼 墨
大陆架是什么	大陆架是大陆向海洋的自然延伸，是陆地的一部分
TVB剧《法网狙击》中女主角“况天蓝”是由哪位女明星扮演的	杨怡
北京故宫的乾清宫正殿宝座上方悬挂的牌匾上写有哪几个字	乾清宫正殿宝座上方悬着由清朝顺治皇帝御笔亲书的“正大光明”匾
根据植物茎的性质，可将植物分为木本植物和什么	根据植物茎的性质不同,将茎分为木本植物和草本植物两大类
曾经有一份真诚的爱情放在我面前，我没有珍惜，是哪部电影台词	大话西游
通常吧利用某种职权打击报复，置人与困境的行为称为给人穿什么鞋	穿小鞋
香港著名演员米雪的妹妹是谁	雪梨
为什么停车信号用红色	我们知道,光线通过空气时会发生散射,对于相同的媒质来说,光线的波长越短,散射作用越强,光线的波长越长,散射作用就越弱
《陆小凤传奇》中西门吹雪的老婆叫什么名字	孙秀青 第八轮 汪磊PK刘佳丽
Halloween是什么意思	您的问题很简单
毛泽东是哪天去世的	毛泽东逝世日期是1976年9月9日
今年欧洲杯有哪几支参赛队伍	共有53支队伍参赛!
我们一般会用“言午”来形容哪个姓氏	?许
在物理学中的电路图中一个圆圈内加一把叉表示什么	电灯泡
街头用于抢险救灾的消防栓，主体是什么颜色	红色
第一次世界大战开始的时间是	第一次世界大战从1914年8月开始到1918年11月,历时4年3个月,战火席卷欧、亚、非三大洲,参战国家地区达34个,受战祸波及的人口达15亿以上,约占世
希腊神话中阿特柔斯之子，特洛亚战争中希腊方面的统帅是谁	阿伽门农
张纪中版的《天龙八部》里王语嫣的扮演者是哪位内的的演员	刘亦菲 的演员
我国最大的淡水湖是哪个淡水湖	中国最深的淡水湖--抚仙湖中国最大的咸水湖--青海湖 中国最深咸水湖泊是位于长白山主峰白头山上的天池
333这首经典歌曲是哪位男歌手的代表作	?蔡国庆
我们常说在分配方面存在平均主义，干好干坏一个样叫做吃什么饭	一、收入差距过大的原因基尼系数,是一个用来描述收入整体差距程度的重要指标
手抓饭主要是我国哪个少数民族款待宾客的传统美食	:解决方案1:维吾尔族
小说《平凡的世界》出自我国哪位著名作家之手	路遥
世界上最大的佛像雕塑在我国四川哪个城市	游人们在瞻仰它的时候,莫不对我国古代的雕塑师们在设计和塑造这尊佛像时所...就在这三江汇合得地方,坐着一尊世界上最大的佛像-乐山凌云大佛
本轮欧债危机最主要的导火索是哪个欧洲国家	希腊
哪两个南美国家不与巴西接壤	不是,还有智利和厄瓜多尔等国家没有和巴西接壤
苹果当中含有增强记忆力的微量元素是什么	微量元素锌有增强记忆力的作用 苹果是美容佳品,既能减肥,又可使皮肤润滑柔嫩
电影《诺丁山》是主要取景地诺丁山是在欧洲哪个城市	伦敦
最容易使用的乐器是什么	如果我来说民族乐器里的古筝是很好学的它可一在半年里就能练到10级
达尔文的哪本著作详细的论述和解释了“进化论”	王老师给您解释这个问题:有关这一部分没用现在在人教版必修二第七章有讲解
我国著名“大昭寺”“小昭寺”位于西藏自治区的哪个城市	西藏自治区的 拉萨
脍炙人口的歌曲《同桌的你》由哪位内地男歌手原唱	老狼 男歌手原唱
西餐中，用各种水果或蔬菜切成小块，加调味品拌成的菜叫什么	沙拉哦
由郭德纲创立的一个相声社团叫什么名字	德云社 德云社 德云社
陆游的《游山西村》写到，“山重水复疑无路”的下一句是什么	一水护田将绿绕, 两山排闼送青来
少林寺为什么有名	1.因为少林寺在明朝的时候为中国人民打过倭寇,深受老百姓的尊重
名著《三国演义》中，在周瑜死后接替其领兵驻守陆口，维护孙刘联盟的人是谁	维护孙刘联盟的 鲁肃
曾经风靡一时的网络歌曲《丁香花》是哪位内地网络歌手的作品	唐磊 的作品
电影《变形金刚》中，与擎天柱作对的反派首领叫什么	123里面都有威震天,不过23的大反派不是他
手抓饭主要是我国哪个少数民族款待宾客的传统美食	:解决方案1:维吾尔族
最快的交通工具是什么	转自凤凰:河南禹州一农民为了逃避过路费,拿着两套假军车牌照营运,8个月里免费通行高速2361次,偷逃过路费368万余元
在什么年代中国男人是扎辫子的	史蒂文·席格 Steven Seagal
由内地实力男星韩磊演唱的电视剧《康熙王朝》的主题曲叫什么	《向天再借五百年》
最近最流行的网络歌曲是什么	1、《上了你的船》
“敦煌八景”之一，鸣沙山旁的泉水叫什么	月牙泉-敦煌月牙泉编辑词条月牙泉即鸣沙山─月牙泉风景名胜区
“将军三箭定天山，战士长歌入汉关”说的是唐朝哪位将军	昔唐高宗年间,铁勒进犯我朝边疆,薛仁贵奉旨讨伐,出征前唐高宗对薛仁贵说;“古善射有穿七札者,卿试以五甲射焉
因饰演了《梅花三弄》《一帘幽梦》等琼瑶剧而出名的女演员是谁	陈德容
艾米所写的《山楂树之恋》被哪位导演翻拍成电影	张艺谋
位于俄罗斯的太平洋沿岸著名海港城市符拉迪沃斯托克又名什么	海参崴
歌词“古老的东方有一条龙，它的名字叫中国”来自哪首歌	龙的传人
代表作有《大淖记事》、《受戒》的是哪位江苏高邮作家	汪曾祺
出自《乐府诗集》，相对于大家闺秀，小户人家年轻美貌的女子常称之为什么	小家碧玉
我国“八一双鹿队”现任维吾尔族主教练，被誉为“篮球场上的魔术师”的是谁	阿的江 现任维吾尔族主教练
美人鱼雕像在丹麦的哪个城市	哥本哈根
成语“韦编三绝”说的是哪个人物翻书多到把编连竹简的皮绳弄断了多次	孔子
位于南美洲，唯一一个与海相通的湖是什么湖	马拉开波湖
坐落在上海黄浦江畔的著名电视塔，叫做什么名字	东方明珠
联合国是什么时候成立	联合国创建于世界反法西斯战争胜利的凯歌声中
港剧《鉴证实录》中男主角曾家原警探是由哪位香港明星扮演	林保怡
在007系列电影《黄金眼》《明日帝国》中的“邦德”是谁饰演的	皮尔斯布鲁斯南
台湾七十年代著名女演员，著名影星成龙的现任妻子叫什么名字	林凤娇
内地著名歌手孙楠的前妻是哪位著名小品演员	买红妹
旧时由婆家养育，待到成年后正式结婚的女孩子叫什么	童养媳
奥本海默是谁	奥本海默有美国的“原子弹之父”之称
冰球运动起源于哪个国家	冰球运动起源于150年前的加拿大，很快传播到了欧洲及世界各国
常用于足球比赛后颁奖仪式的歌曲《Wearethechampions》是哪个乐队的经典歌曲	《WeAreTheChampions》歌曲背景(转载):《Wearethechampion》最早是一首同性恋歌曲,1994年美国世界杯主题曲,现在成了弘扬体育精神和奥运冠军的经典庆贺曲目
由于毛孔堵塞而生长在鼻子上的黑色细小颗粒俗称为什么	俗称为 黑头
新婚吉庆时，通常会在新房贴上哪个字来讨好彩头	喜(双喜) 讨好彩头
用什么动物表示股票市场普遍上涨，延续时间较长的大升市	牛啊
歌手孟庭苇演唱的歌曲中唱到“冬季到哪里来看雨，别在异乡哭泣”	台北
小说《妻妾成群》是我国哪位当代著名作家的代表作	苏童
克里奥佩特拉是哪个王朝的君主	托勒密王朝的君主,埃及王后
《周易》中，“乾”是天的意思，那么什么字是“地”的意思	坤的意思是“地”是“阴”是“臣”是“女”
建立了隋朝的隋文帝的名字是什么	直接给你上史料吧,丞相是高熲,其他功臣什么官职请看括弧里的内容,其他可忽略 开皇元年二月甲子,上自相府常服入宫,备礼即皇帝位于临光殿
胎儿刚出生时身上的毛发被称为什么毛	 胎毛
1981年戴安娜与查尔斯的婚礼大典在英国哪个大教堂举行	1981年7月29日,英国王储查尔斯王子和戴安娜公主在伦敦圣保罗教堂举行结婚典
水凝固后叫什么	一般水玻璃在空气中或者二氧化碳气氛中会干燥固化,半透明的树脂状,有一定硬度,见水缓慢溶胀变软,因为他是水性的.可以追问
被称为“狮王”的德国＊＊门将是谁	2010-07-10
日系轿车有哪些品牌	日本汽车品牌:丰田汽车和旗下的雷克萨斯(凌志)
加利福尼亚的首府在哪里	加利福尼亚
会飞的不一定是鸟类，蝙蝠从形态结构上就属于哪种种类的动物	哺乳类类的动物
游戏“两只小蜜蜂”中，如果游戏双方出的一样会做出哪种动作	是一种两人游戏
代表美国参加奥运会的男子篮球队被称作什么	瑞克·尚托,来自美国!这不是感冒,这是癌症啊!当我情绪低落时,我会向我的教练、队友们寻求安慰
越南的主要货币称之为什么	越南货币的主币名称的与荷兰相同 , 被称为: 盾
主演了《心灵捕手》《谍影重重》三部曲《十三罗汉》的是哪位好莱坞男星	马特达蒙
数学领域中所说的圆周率指的是圆形的周长与什么的比例	直径
罗马城的城徽上面有哪种动物	狼
电视剧《上错花轿嫁对郎》中齐府三公子齐天磊是由哪位内地著名男演员饰演	是内地著名小生聂远,饰演的,剧情不错结局大圆满,应了那句上错花轿嫁对郎
常温中唯一呈液态的是哪种金属	在常温状态下唯一呈现液态的金属是汞，即水银
我们通常用把夫妻新婚过后休假的一段时间叫什么月	蜜月
除夏威夷之外，哪个州也是美国本土以外的州	阿拉斯加州是除夏威夷之外的美国本土以外的州
我们常用“舍不得孩子套不着什么”来比喻要达到某一目的必须付出代价	狼
“荷兰三剑客”之一，人称“辫帅”的是哪位已退役的著名球星	古利特/路德·古利特
法国资产阶级革命是以巴黎人民攻占何地的起义为序幕	攻占巴士底狱的历史 多少年来,人们像痛恨封建制度一样痛恨这座万恶的巴士底狱
声速有多快	洲际导弹最快25马赫，现有的最快空空导弹约6马赫
1999年播出的韩国电视剧《汉城奇缘》中的饰演皮鞋设计师李汉妮是哪一位韩国女星	金喜善
我国劳动法规定禁止用人单位招用未满多少周岁的未成年人	《中华人民共和国未成年人保护法》第三十八条任何组织或者个人不得招用未满十六周岁的未成年人,国家另有规定的除外
提出“兼相爱交相利”的是先秦的哪位思想家	墨子 墨子
非洲国家南非的立法首都是哪座城市	开普敦
演唱《桃花朵朵开》的马来西亚歌手陈庆祥的艺名是什么	阿
音乐家舒伯特是哪国人	奥地利人
在我国神话传说中，哪个神专管人间婚嫁之事	月老
二战时期，美军以少胜多，成为二战太平洋战区转折点的是哪一场战役	中途岛战役
作为一种流行发式的梨花头兴起于哪个亚洲国家	作为一种流行发式的梨花头兴起于哪个亚洲国家? 日本
一战导火索事件的发生地萨拉热窝位于哪个半岛上	C 本题考查的是萨拉热窝事件
大汶口文化遗址在我国哪里	大汶口遗址在山东省泰安市大汶村南,大汶河东西贯穿,将遗址分为南北两片,北片在卫架庄东,为大汶口文化的代表遗址和命名地
钢琴是乐器之王，哪种弦乐器是乐器之后	哪种乐器被称为西洋乐器之后? 小提琴是被称为西洋乐器除钢琴外最难精通的乐器,钢琴为乐器之王,小提琴为乐器之后
NBA中马刺队有三位球星合称“GDP”其中的D是指谁	邓肯
我们常说“红花需要什么衬”	绿叶
“信天游”是中国哪个省的民歌风格	陕西
把大梨分给别人的故事出自《三字经》中哪一个著名典故	孔融让梨
中国画术语吴常当风是对哪位画圣画风的概述	吴道子
由金城武和梁咏琪主演，改编自几米漫画的电影是哪部	《向左走向右走》
在日常生活中最常见的螺丝刀的头有“一字型”和什么字型	在日常生活中最常见的螺丝刀的头有 “一字型” 和什么字型? 十 字型
在CBA联赛中，以东北虎命名的是我国哪个城市的篮球俱乐部	吉林 的篮球俱乐部
中国旅游涉外星级酒店中，最高档的酒店是几颗星	五颗
《我们仨》的作者，著名作家钱钟书的妻子是哪位文人	是钱钟书先生杨绛简介 本名杨季康(1911—),祖籍江苏无锡,生于北京
泰国男演员马里奥.毛瑞尔在哪部泰国青春爱情喜剧电影中扮演阿亮学长	初恋这件小事
商店中碰到这样的符号“$”，表示要用什么币种付款	美元
清代著名章回体小说《儒林外史》的作者是谁	吴敬梓
哥斯达黎加的首都是哪座城市	圣何塞
会吐丝做茧的蚕，它以吃什么植物的树叶为生	桑树 植物的树叶为
水占人体重量的百分之多少	随着年龄的增长，水占人体体重的比例会逐渐下降
在2010年南非世界杯上获得金球奖的乌拉圭前锋是谁	2010年南非世界杯,弗兰率领乌拉圭足球队时隔40年后再次挺进四强
秦始皇长子叫什么名字	扶苏----秦始皇长子(?—前210) 是秦朝统治者中具有政治远见的人物
在我国，家中排行老大的称作“伯”，那么排第二的称作什么	季 季 季
历史事件王莽篡夺王位改国号为新，是篡夺的哪个朝代的王权	汉朝
邓丽君演唱的《小城故事》中，“小城故事多”的下一句是什么	充满喜和乐
著名小说《爱丽丝梦游仙境》是哪位英国作家的作品	路易斯.卡罗尔
西方传统中，结婚时戒指应该戴在哪个指头	应该戴在 无名指
赵州桥的又名是什么	楼上二位不知道就不要献丑了
文艺复兴时期的“美术三杰”中，擅长画圣母像的画家是哪位	拉斐尔(Raffaello Sanzio,1483年4月6日-1520年4月6日) 资料:被誉为意大利文艺复兴三杰之一,怀抱着新柏拉图主艺术理想,以其洗练的画技,将文艺复兴的
贺知章的“不知细叶谁裁出”的下一句是什么	诗句“不知细叶谁裁出,二月春风似剪
由韩彩英、在煕共同出演的改编自韩国传统民间故事的是哪部韩剧	 《韩杰春香》99、被孔子赞美为“一箪食,一瓢饮,居陋巷”仍能不改其志的是孔
格林尼威天文台位于哪个城市	格林威治天文台位于英国首都伦敦东南 8 公里处的格林威治地区
我们常用什么油炸食物来指称把头发分成三束交叉扎起来的辫子	麻花
空调遥控器的屏幕上出现了“太阳”的符号，代表此时空调运行哪种模式	海尔空调遥控器太阳标志的含义:制热模式
第一次世界大战开始的时间是	第一次世界大战从1914年8月开始到1918年11月,历时4年3个月,战火席卷欧、亚、非三大洲,参战国家地区达34个,受战祸波及的人口达15亿以上,约占世
历史上著名的“商鞅变法”在是哪位国君即将以后开展的改革运动	秦孝公
宝洁公司总部在美国的哪里	始创于1837年的宝洁公司在 美国辛辛那提 ,是世界最大的日用消费品公司之
一个世纪是多少年	100
代表作有《竞选州长》、《汤姆索亚历险记》的是哪位美国著名作家	马克吐温
织女星位于哪个星座	织女星位于天琴座
“阿哩阿哆”是哪个亚洲国家语言中“谢谢”的说法	日本
电视剧《北京青年》中，李晨饰演的角色叫什么名字	何东
“草船借箭”中诸葛亮借的是哪国的箭	草船借箭 【汉语拼音】: cǎo chuǎn jiè jiàn 【释义】: 运用智谋,凭借他人的人力或财力来达到自己的目的
马头琴是我国哪个少数民族的乐器	d.蒙古族
石破天、石中玉是金庸哪部小说中的主人公	侠客行////'''
俗语所说“一年之计”在于哪个季节	一年之计春
电脑中央处理器英文简写是什么	CPU
东方明珠电视塔在哪里	上海东方明珠广播电视塔坐落于上海浦东新区陆家嘴嘴尖上,以其468米的绝对高度成为亚洲第一、世界第三之高塔
国花是仙人掌的是哪个美洲国家	墨西哥
名句“衣带渐宽终不悔，为伊消得人憔悴”是出自哪位北宋著名词人之手	柳永之手
号称“人屠”的战国时期秦国名将是谁	白起(?—前258),也叫公孙起,号称“人屠”,战国四将之一(其他三人分别是王翦、廉颇、李牧)战国时期秦国名将
曾效力于芝加哥公牛队的NBA著名球星丹尼斯.罗德曼的绰号是什么	大虫
2008年奥运会带领美国女排获得亚军的主教练是谁	郎平 之前在美国,她现在已经回中国了
曾效力于意甲AC米兰，身披10号球衣的葡萄牙“黄金一代”的中场球员是谁	鲁伊科斯塔
我国的澳门在清朝末期曾经被哪个欧洲国家侵略并占领过	葡萄牙
高卢鸡是哪个欧洲国家的象征	法国
目前世界上市值最高的是哪家美国高科技公司	苹果
我国收入字最多的字典是哪部	《汉语大字典》西汉的《仓颉篇》仅有3300字;东汉的《说文解字》收录了9353字;清朝的《康煕字典》突破了47000字;现在的《汉语大字典》所收汉字高达
在系列电视剧《活佛济公》中饰演“济公”的是哪位香港男演员	陈浩民
在《北京爱情故事》中出演程峰外号“疯子”并是该片导演的人是谁	陈思成
生活中的豆腐是用哪种豆类制成的	大豆/黄豆
缩写为“L.A”的是美国哪座著名城市	洛杉矶
奥运会击剑比赛项目分为三项，花剑、重剑和什么	花剑 分男子和女子,均有个人赛和团体赛
元宵灯谜“锦囊妙计（打一新用语）”的谜底是什么	如果说赋隐是事物谜(谜语)的过渡形式,那么文义谜(灯谜)是由离合过渡而成的
我们常把家中的独生子称作“小皇帝”，把独生女称作什么	你好,朋友
和服是哪个国家的民族服装	难道还不明白吗 是 日本 年关将至,烦恼中踱步阳台,寻思家庭资产连年大幅缩水,在武汉休息两三天看一看当地的风景品尝一下当地的小吃还是最终
佛家说的“放下屠刀”下一句的是什么	立地成佛
世界第一大水电工程三峡大坝位于我国哪个省	世界第一大水电工程三峡大坝位于我国哪个省? 湖北
首创了奥运会商业运作的“私营模式”，被誉为“奥林匹克商业之父”的是谁	尤伯罗斯
法网大满贯中，法网比赛场地是红土，温网的比赛场地是什么	6
大都是哪个朝代的首都	我国八大古都 郑州就是所谓的开封，都在河南省
位于德国莱茵河西部的以采煤工业起家的工业区叫什么	鲁尔工业区
李闯王是指明末哪位农民起义领袖	李自成
中南半岛上唯一一个内陆国家老挝的首都是哪	解答:解:中南半岛唯一的内陆国是老挝,其首都是万象,属于热带季风气候.故选:D
荷兰的国花是什么花	郁金香花语郁金香花语一： 爱的表白、荣誉的皇冠、永恒的祝福 花箴言：走出孤独，自然会邂逅永远的爱情 红郁金香：爱的宣言、喜悦、热爱黑
儒家学派的孔子被称为“圣人”，那么谁被称为“亚圣”	孟子
固定资产转让要缴纳哪些税	1、销售使用过的固定资产同时具备以下三个条件的免征增值税
司南是我国四大发明中哪件物品的前身	指南针
李春波的经典代表歌曲中唱到“村里有个姑娘叫什么，长得好看又善良”	1、歌词“有一个姑娘叫小芳,长得美丽又善良”(歌词中是小芳不是小方)出自歌曲《小芳》,是李春波的单曲,发行于1994年
小说《暗算》和《风声》的作者是谁	麦家 　麦家,居成都,出版有长篇小说《解密》、《暗算》小说集《紫密黑密》《地下的天空》《让蒙面人说话》等多部
我国海南岛与广东省的雷州半岛之间所夹的海峡是什么海峡	琼州海峡
在一副扑克牌中，J代表11，那么K代表数字几	你好 很荣幸能回答 J-11 Q-12 K-13 扑克牌中的J、Q、K是英文中侍从、王后、国王的缩写
谚语“若要人不知”的下一句是	除非己莫为
在同一平面内，过三点最多可以画几条直线	3种,任选其中两条做一条直线,再过另一点作它的平行线,有且仅有一条,而任选两条直线有三种选法,所以这样的平行线能画
宋代诗人叶绍翁的诗词《游园不值》中“春色满园关不住”的下一句是	一枝红杏出墙来
女方在怀孕期间，分娩后多长时间内，男方不得提出离婚	分娩后的一年之内，是不得离婚的
政府的通信地址是多少	余井镇人民政府(红点)
第一次奥林匹克运动会是哪年举行的	1932年,第十届奥运会在美国洛杉矶举
家严是对自己家中什么直系亲属的称呼	父亲 父亲
《红楼梦》中，林黛玉在大观园中的住所的名字是什么	荣国府: 荣国府为一正两厢鹿顶钻山形式的多进四合院
功夫“排山倒海”是情景喜剧《武林外传》中哪位角色经常使用的功夫	郭
中国唯一一个承办了F1世界一级方程式比赛分站赛的城市是哪里	上海,每年都有F1上海站,中国其它城市没有,在上海国际赛车场
著名的贞观之治发生在哪个朝代	唐朝
2011年第41届世界园艺博览会在我国的哪个著名古城举办	西安 古城举办
有蝴蝶8只，蜻蜓比蝴蝶多4只。那么蝴蝶和蜻蜓一共有多少只	20
戴高乐是怎么死的	你好,生病死的,夏尔·戴高乐是法国国务、军事、政治活动家,准将
《因为爱所以爱》，《谢谢你的爱1999》是哪位香港艺人的歌曲	谢霆锋
俗话说“胜者为王”下一句是	 败者为寇
我国三国时期的名医华佗是被哪位大枭雄所杀	曹操
著名景点羊八井地热蒸汽田位于我国西藏自治区的哪个城市	拉萨
在周星驰电影《食神》中饰演女主角双刀刃火鸡的是哪位女明星	莫文蔚
电视剧《金太郎的幸福生活》中饰演女主角小米妈妈的是哪位著名小品女演员	抱歉,这个我们无法为您做出准确的回答,请谅解
2004届世界足球先生效力于哪个俱乐部	由各国足协、各大洲足协在每年末根据球员在当年的全部俱乐部和国家队比赛的综合...2010-01-04
小学语文中，从打破花瓶的故事中懂得了诚信的是哪位俄国伟人	列宁
在太空中，宇航员呈漂浮状态主要是由于什么原因造成的	人与地球之中存在着万有引力,也就是指我们的重力,重力随着海拔的增高逐渐减小
出自孔子《论语》：“君子坦荡荡”下一句是什么	小人长戚戚
鸵鸟能跑出怎样的速度呢	1、V=S/t=5600m÷80S=70m/s答:鸵鸟的平均速度是70m/s(PS:70m/s是鸵鸟的平均速度)2、灵灵自己也是小朋友,算在幼儿园的小朋友的九个之内的话
移动公司的广告费是多少	原来
写出了《巨人传》等名著的是哪位法国的著名文艺复兴时期作家	拉伯雷
《名侦探柯南》中与工藤新一齐名的关西高中生名侦探是谁	服部平次
世界公认的四大文明古国是中国、古埃及、古印度和哪个古国	古希腊
著名的“撒尿小孩”铜像是比利时哪个城市的市标	是比利时首都布鲁塞尔的市标
儿歌《小燕子》开头歌词“小燕子，穿花衣”的下一句是什么	年年春天来这里 ,要问燕子你为啥来 燕子说这里的春天最美丽
王昌龄的《出塞》中，“秦时明月汉时关”的下一句是什么	万里长征人未还
戴上一根红丝带的公益活动是呼吁大家对哪种病的帮助和关系	艾滋病
毛利人是对哪个大洋洲国家原住民的称呼	新西兰
希腊神话中宙斯最忠实的信使，掌握畜牧、商业的神叫什么	赫尔墨斯
最小的岛国瑙鲁国位于五大洲的哪个洲	大洋洲,../
为了防止过敏，打青霉素针之前要先做什么	必须做皮试,就是用小量青霉素药水注入你的皮肤,如果你的皮肤膨胀,便对青霉素过敏,不可注射青霉素药剂;如果皮肤没有反应,便可以注射青霉素药
什么岛是圆形的	环形路的面积=3.14×(40+15)-3.14×40=3.14×(55-40)=3.14×1425=4474.5(平方米)答:这个环形路占地4474.5平方米
俄罗斯“和平号”空间站在太空工作了多长时间	俄罗斯“和平号”空间站在太空工作了15年 “和平号”空间站于1986年2月20日发射升空，1996年4月26日该空间站的最后一个组成部分“自然”号
互联网浏览器马赛克是哪个公司发明的	Intetnet是全世界最大的计算机网络,它起源于美国国防部高级研究计划局(ARPA)于1968年主持研制的用于支持军事研究的计算机实验网ARPANET
成名曲有《九百九十九朵玫瑰》《千纸鹤》等歌曲的台湾男歌手是	邰正宵
中国最大的商业银行是哪个银行	最大的商业银行是农业银行,因为他的网点可以说遍布城乡
刘玉玺的诗歌《竹枝词》中“东边日出西边雨”的下一句	道是无情却有情
毛主席的名句“谁敢横刀立马，唯我彭大将军！”中的彭大将军指的是谁	彭德
叶子受到外力触碰会立刻闭合的植物，学名叫什么	是含羞草 的
目前我国邮政储蓄异地取款手续费的最高限额是多少元	50
“弱冠之年”是古代社会对男子满多少岁时的年龄称谓	20
古代的死刑在什么季节行刑	古代执行死刑一般是在秋冬季节,这与古人的自然神权观念有关,即顺应天意
霸王别姬是京剧中有名的桥段，请问项羽在那条河边自刎的	乌江,中国贵州省第一大河,长江上游右岸支流
雷.查尔斯最拿手演奏的是什么乐器	管风琴
中国十大古典曲之一的《高山流水》曲作者是谁	作者是 俞伯牙
哪个节气在每年农历5月5日或6日，表示夏天的开始	立夏吧表示夏天的开始
一尺比一丈的长度长	我国传统的长度单位有里、丈、尺、寸等
二胡乐器的拉弓上的弓毛是用什么动物的毛制作而成的	一般都是用马尾制做,因为马尾毛上有些小锯齿似得凸起能增大摩擦力 另外,还有一种是尼龙的,但效果没马尾的好
获得欧洲冠军杯次数最多的是西甲的哪支球队	1.西甲夺冠次数最多的是皇家马德里,共夺得西甲联赛冠军:31次
中国最早文献记载并可查的桥是属于哪类桥梁	《诗经》中有“文定厥样 ,亲迎于渭
你使用过什么型号的交通工具	俺老孙 去也!
代表作有《闲散的时光》《唐璜》的英国19世纪初期伟大的浪漫主义诗人是谁	拜伦
美国的太平洋沿岸城市“圣迭戈市”（圣地亚哥市）位于哪个州	加利福尼亚州
两次世界大战分别爆发于哪年	1.第一次世界大战(简称一战;英语:WorldWarI、WWI、GreatWar)是一场于1914年7月28日至1918年11月11日主要发生在欧洲
“7UP”是我们常喝的哪种碳酸饮料	七喜
西藏布达拉宫最初是松赞干布为了迎接谁而兴建的	文成公主. . 文成公主
谁发现闪电是一种电	没错,是一种放电现象,原理和衣服静电差不多
屈原活了多大年纪	屈原(约公元前339
中国男子110米跨栏项目中有“南刘北史”的说法，南刘是刘翔，北史是谁	史冬鹏
测量降雨量的多少，我们一般用什么为单位	毫米为单位
调味料中的“十三香”中以树皮为原料的是取自哪种树	桂树上的桂皮
在《青青河边草》中饰演朱漱兰的是哪位知名女演员	刘雪华
德国最大的金融中心在哪个城市	与美国纽约并列世界上最大的金融中心
腊月是农历几月	腊月是农历是十二月
亚洲第一个举办夏季奥运会的国家是	1964年10月10日到24日，第18届夏季奥运会在日本东京举
“读书百遍，其义自见”中的“见”的哪个字的通假字	嗯,当然是通假字,和你说的一样,通“现”,出现的意思.释源:《三国志》裴松之注.《三国志·魏志·王肃传》:“明帝时大司农弘农董遇等,亦历注
主场在纽约的NBA球队是哪支	1、纽约尼克斯在美国本土球迷最多
儿歌“一闪一闪亮晶晶”的下一句是什么	爱的小星星 专辑:非你莫属 作词:莫小娘 作曲:莫小娘 编曲:韦波安 混音:韦波安 演唱:莫小娘&韦波安
哥伦比亚的人均收入是多少	93
NBA历史上著名的奥本山宫事件中的奥本山宫是那只NBA球队的主场	底特律活塞
网球名将李娜的老公是哪位国内知名网球教练	姜山 从小和李娜一起在湖北省队训练 后来放弃了职业选手成为了李娜的教练
“凯撒大帝”是古代哪个国家的杰出军事统领	古罗马
世界面积第一大沙漠是什么	撒哈拉沙漠 撒哈拉沙漠游是突尼斯旅游的另一个重要内容,而且近年来行情看涨
“钢丝”是哪位艺人的粉丝最常用的称呼	不是李玉刚的粉丝吗
源自日文对姐蛆的敬称，很多人会把成熟的强势的女性叫什么	强势的女性叫 御姐
演唱了电影《狮子王》主题曲和《风中之烛》的是哪位英国著名音乐人	艾尔顿·约翰
迪斯尼的哪部电影，讲述了一个由猿抚育成人的森林英雄的故事	人猿泰山
2000年哪位中国运动员获得悉尼奥运会女子10米气手枪冠军	陶璐娜
据第六次人口普查结果，我国人口数量最多的少数民族自治区是哪一个	广西壮族
机器猫哆啦A梦是大雄的哪位亲属派过来保护他的	大雄的孙子
前苏联重要节日群众集会和阅兵“红场”位于现在的哪个欧洲国家	俄罗斯
与颜真卿并称“颜筋柳骨”的唐代著名书法家是谁	柳公权
被称为“世界第八奇观”的是什么	兵马俑：秦始皇兵马俑博物馆，是建立在兵马俑坑原址上的遗址性博物馆
晋朝开国君主司马炎之后的一位晋国君主是谁	司马衷
日本动漫《圣斗士星矢》中，青铜五战士中的一辉的弟弟叫什么名字	一辉的弟弟叫 阿顺
“才自精明志自高”是《红楼梦》中谁的判词	探春
中国第一大岛是哪个	库页岛历史上曾经是中国的.库页岛是原中国最大的岛屿
陈凯歌导演的电影《梅兰芳》中，扮演“冬皇”孟小冬的是哪位演员	章子怡
80年代著名歌唱组合“达明一派”中，明是黄耀明，达是谁	刘以达
比喻培养人才是长久之计时，我们通常说“十年树木”，后面一句是什么	百年树人
中国最大的沙漠是哪个	塔克拉玛干大沙漠位于塔里木盆地中央，东西长约
发表了著名的“铁幕演说”的是二战时期的哪位领导人	丘吉尔哦
微软公司推出的官司方浏览器的图标是哪个英文字母	E 英文字母
小说《封神演义》中，“托塔天王”李靖曾经是什么关的总兵	小说《封神演义》中,“托塔天王”李靖曾经是陈塘关的总兵
著名音乐人李宗盛的前妻是哪位女星	林忆莲 林忆莲 林忆莲 林忆莲 林忆莲 林忆莲 林忆莲 林忆莲 林忆莲
演唱了《长城》，《不再犹豫》的香港殿堂级摇滚乐队叫什么	摇滚乐队叫 beyond
我国首次世界园艺博览会是在哪个城市举办的	第三十届世界园艺博览会从2011年4月28日开始,至10月22日结束在陕西省西安市举
有着“黑曼巴”称号的是哪支湖人队的NBA巨星	科比
《天龙八部》中，段誉来自大理国，请问大理国都城在现在我国哪个省境内	云南 省境内
悉尼奥运会中国代表团的指定饮料是什么	芝麻团  芝麻将  财富商城  知道之星  知道活动 ...2008-08-30 奥运会中国运动员喝的蓝色饮料是什么啊...佳得乐是NBA指定饮料 百事产的
街头用于抢险救灾的消防栓，主体是什么颜色	红色
曾经效力于大连万达队被誉为“亚洲第一前锋”的是我国哪位著名国脚	郝海东
第一位专职青少年节目主持人，曾主持《七巧板》节目的是什么姐姐	鞠萍哦
什么样的人可称为君子	两千多年前,孔子及其门徒重点研究了两种人,一为君子,二为小人
李白提到的蜀道，在如今哪个省内	四川哦
利用七块几何形状的板拼成不同形状的一种益智玩具叫什么	益智玩具叫七巧板
我国第一个实现特殊经济政策和管理体制的经济特区是哪个城市	深圳
1965年苏联著名作家肖洛霍夫因为哪本书获得了诺贝尔文学奖	《静静的顿河》
美剧《绯闻女孩》讲述了一群生活在曼哈顿的青少年的故事，曼哈顿属于哪个美国大都市	曼哈顿属于 纽约
活着的大闸蟹背是青色，煮熟后会变成什么颜色	红色
1911年“中国同盟会”的领袖，被称为“中华民国国父”的是哪位革命家	孙中山
美国在哪些年发射过火星探测器	第一宇宙速度:v=7.9km/s;它是卫星在地面附近绕地球做匀速圆周运动所必须具备的速度.第二宇宙速度:v=11.2km/s.它是卫
美国历史上第一位女国务卿奥尔布赖特任职于哪位美国总统的执政期	克林顿
第一次播放CNN是什么时候	《新闻联播》 　　发展史 　　1976年7月1日,北京电视台第一次试播《全国电视新闻联播》,播出时间10~15分钟,只有外景片,没有播音间的口播
地球上海洋面积有多大	地球总表面积 5.11亿平方千米 地球陆地面积 1.49亿平方千米(约为地球表面积的29%) 地球海洋面积 3.62亿平方千米(约为地球表面积的71%)
“质能方程”是哪位著名物理学家提出的	爱因斯坦
我国“八一双鹿队”现任维吾尔族主教练，被誉为“篮球场上的魔术师”的是谁	阿的江 现任维吾尔族主教练
《清明上河图》描绘的是哪个朝代的市井生活	宋/北宋
以色列是哪个民族的人最集中的国家	那块土地本名叫“巴勒斯坦
有微笑天使之称的宠物犬是什么犬	萨摩耶
率领西班牙男子足球队夺得2012年欧洲杯的主教练叫什么名字	博斯克第五轮:李立成PK杨雪娇1、著名的美索不达米亚平原位于五大洲中的哪个大洲?亚洲2、
人们常用“接风”和什么此连用来形容宴请远道而来的客人	接风洗尘
流行歌曲《蝴蝶泉边》中唱到的蝴蝶泉位于云南的哪座城市	位于云南的 大理
波尔是谁	波尔是川藏线服务站的老板,淘宝上搜得到他的店,实体店我也去过,很小
世界上历史最悠久的树是什么树	一、世界上最大的树：它是美国加利福尼亚的一棵巨杉
歌曲《美丽笨女人》的原唱是哪位著名女歌手	李玟
生活中与“三伏”相对，一年中最冷的日子我们称为什么	初伏、中伏、末伏这三个伏日,是一年中最热的三天,故又称为“三伏日”、“三伏天”
豫剧《七品芝麻官》中“当官不为民做主”后一句是什么	不如回家卖红薯
东北林业大学的面积是多少	136
江西第一个世界自然遗产，被誉为“江南第一仙山”的是哪座山	江南第一仙山”的是 三清山
大气中含量最高的元素是什么	大气中氮气体积分数占78%,氧气占21%,二氧化碳占0.5%左右,稀有气体(氦、氖、氩、氪、氙、氡)占0.5%左右.含量最高的是氮如果硬要挤出三种,那应该
汉字中的“廿”表示的是阿拉伯数字的几十	20,太简单位了
朱自清的散文《背影》，描写的是作者的什么亲属送别他远行的场景	父亲
南京的紫金山又叫什么山	夫子庙 Confucius Temple 玄武湖 Xuanwu Lake 中山陵 Dr.Sun Yatsen's Mausoleum 紫金山 Purple Mountain or Zijin Mountain乌衣巷拿不准我有南京的英文
丝绸之路贯穿哪两块大陆	中国和阿拉伯
民间说法中炸油条的来历和南宋年间哪位奸臣有关	秦桧
我们通常将拨打电话时，被叫方处于通话忙碌状态称作为什么	　　占线的主要原因: 对方正在给别人打电话 对方在给自己打电话 对方电话未放好 电话机之间线路忙指拨打电话时,被叫方处于通话状态
俗语说“酒香不怕什么深”	说实话,在这什么都是“速成”的时代是行不通,就算酒香不怕巷子深,可是要让酒挥发出香味也是需要时间的
扑克牌中的“Q”代表的是什么	　　J---Jack Q---Queen K---King 　　扑克(poker)有两种意思,一是指扑克牌,也叫纸牌(playing cards),另一个是指以用纸牌来玩的游戏,称为扑克
台湾第一位巡抚，被称为“台湾近代化之父”的是谁	刘铭传
《红楼梦》中，甄士隐被拐走的女儿叫什么名字	甄英莲
打开中美建交大门的最早的外交活动是什么	“乒乓外交” ,中美正式建交
晚上看电视时屋里的灯应该怎样	日光灯应该关闭. 小功率的白炽灯应该打
以描述汉武市井生活为特色，代表作有《生活秀》和《来来往往》的女作家是哪位	女作家 池莉
沙林毒气的主要成分是什么	沙林，学名甲氟膦酸异丙酯，是二战期间德国纳粹研发的一种致命神经性毒气，可以麻痹人的中枢神经
意大利有一座被活火山活埋的城市，叫什么	公元79年被火山活埋的意大利庞贝古城
香港经典电视剧《刑事侦缉档案1》中，男主角张大勇警官由哪位男演员扮演	陶大宇 扮演
歌手范玮琪的老公叫什么名字	范玮琪个人资料及照片
北京的得名是从哪个朝代开始	北京的得名是从哪个朝代开始? 明朝
我们把能抑制牲畜脂肪生长，促进精肉生长的药物叫什么	瘦肉精 瘦肉精 瘦肉精
《薛家将》《呼家将》与哪一部小说构成了我国通俗小说史上著名的“三大家将小说”	《薛家将》、《杨家将》、《呼家将》等构成了我国通俗小说史上著名的“三大家将小说”
在系列电影《暮光之城》中，由罗伯特.帕丁森饰演的吸血鬼男主角叫什么名字	爱德华
08奥运会篮球比赛场馆的名字是	比赛场馆 · 国家体育场 · 国家游泳中心 · 国家体育馆 · 北京射击馆 · 五棵松篮球馆 · 老山自行车馆 · 顺义奥林匹克水上公园 · 中国农业大学
女生把找到有身份地位有前途的男人做老公时，一般会说钓到什么	金龟婿
台湾歌坛著名歌手齐豫的弟弟叫什么	弟弟叫 齐秦
“有心栽花花不开”的下一句是什么	无心插柳柳成阴 希望采纳
古代的五音宫商角徵羽中的羽在现在简谱中写作哪个数字	6
英文child单词在后面加哪三个英文字母表示复数形式	LZman复数形式为menarmchair(我想你可能拼错了)armchairspicture:pictureswindow:windowsknife:knivesbook:booksplate:platesbox:boxeshouswife:houswifi
干葡萄酒的特点是什么	葡萄酒按糖份来划分的话,可以分为干型、半干型、半甜及甜型四种,都有高档的和廉价的:干型糖度:1000毫升含4克以下的糖;半干型糖度:1000毫升含4克
我国哪一银行执行中央银行的职能	人民银行三, 中农工建都是商业银行了,人民银行是银行的银行,不过现在人民银行的职能被分化了
中古阿拉伯民间故事总集《一千零一夜》又名什么	《天方夜谭》
“水灵”是哪位内地女演员的艺名	蒋勤勤
缅甸最长河流萨尔温江在我国境内被称为什么江	怒江
对人体来说安全电压是多少伏	36
《伤寒杂病论》是东汉末年哪位著名医学家的著作	张仲景
中国有多少个省	23
铂金的元素符号是哪两个字母	铂金的元素符号是PT
我国有三大平原，分别是东北平原、长江中下游平原和什么平原	我国三大平原:东北平原,华北平原,长江中下游平
秦观的《鹊桥仙》中，“两情若是长久时”下一句是什么	又岂在朝朝暮暮
在童话《红鞋》中，主人公穿上红鞋会不停地做什么事情	跳舞
黄酒名品“加饭酒”产地是哪个省	浙
今年伦敦奥运会女子团体操比赛有几个项目	4
“明月几时有，把酒问青天”这首词指的是哪个传统节日	中秋
nba篮球比赛中，正常情况下，全场一共分为几节进行	2
原名叶绍钧，代表作有《稻草人》的我国著名教育家，作家的是谁	叶圣陶
巴拿马运河何时才归巴拿马管理	现在由巴拿马运河管理局负责管理,而管理局只向巴拿马政府负责,即收入归巴拿马政府
希腊奥林珀斯十二主神之一，象征战争与智慧的女神是谁	雅典娜
与熊黛林传出绯闻6年有余的香港男星是	郭富城
位于新疆的玉龙喀什河发源于什么山脉	昆仑山,这都不知道
春秋五霸时期，秦国的执政者是谁	秦穆公 秦穆公
世界杯决赛阶段的名额目前是多少个	2010
从地球到火星有多远	距离地球有55757930千米
“碧玉妆成一树高，万条垂下绿丝绦”是出自贺知章哪首诗中的名句	《咏柳》
苏迪曼杯是世界那个运动项目的混合团体锦标赛事	羽毛球
在《封神演义》中，其母怀胎三年零六个月而被生下的人是谁	被生下的人是 哪吒
记录电影《姚之年》讲述的是哪位著名前NBA中国球员的故事	是 姚明啊!
2012年法网女子单打冠军是谁	莎拉波娃
被称为易安居士的是我国南宋的哪位著名女词人	李清照哦
冯小刚电影《非诚勿扰》中，舒淇饰演的梁笑笑的职业是什么	舒淇
俗话说丑媳妇早晚也得见什么人	  公婆
我国的“云贵高原”中的“云”是指的哪个省	云南,对不对
郭晶晶的公公，霍启刚的父亲是谁	霍震霆
乐府名诗《孔雀东南飞》讲述的是焦仲卿和那位女性的爱情悲剧	刘兰芝
小时候玩的游戏“老鹰捉小鸡”中，保护小鸡不受伤害的角色是什么	母鸡 母鸡 母鸡 母鸡
在国际单位制中，压强的单位是什么	压力作用效果(单位面积上的压力) 牛顿/平方米 帕斯卡
被称为“小烟枪”的是哪位著名的阿根廷国脚	伊瓜因
俗语说“慢工出什么活”	慢工出细活
人们常说的“白山黑水”中的“白山”指的是东北的哪座山	长白山
我国建军节是几月几日	你好,中国人民解放军的建军节是每年的八月一日,简称八一建军节,今年的八一刚好是星期六
历史上著名的“管鲍之交”描述的是管仲和谁的友情	鲍叔牙
未名湖和博雅塔是哪所高校的标志性景点	北京大学
中国传统民乐器笛子普遍采用什么原料制作	 竹子
因成功主演《媳妇的美好时代》而被称为“国民媳妇”的是哪位女演员	海清
“莫等闲，白了少年头，空悲切”的作者是哪位抗金名将	作者是 岳飞
我国四川地区的“甘孜”是我国哪个少数名族的自治州	藏族
“阿胶”是山东省哪个县的特产	最早最有名的是山东省东阿县出品的
金庸的十五部小说，哪一部未被收进对联“飞雪连天射白鹿，笑书神侠倚碧鸳”	古龙小说--对联 《古龙70部小说之五对联》 一 洗(碧血洗银枪) 剑(湘妃剑) 浣(浣花洗剑录) 花(护花铃) 新(新月传奇) 月(月异星邪) 残(残金
在拳击比赛中常看到的“Round 1”。请问Round的中文意思是什么	每一局 frame每一场 match每一阶段 game开场时说frame one 或者 the first frame每局结束有 end frame我是一级裁判~以上节选自内部培训教材~
“万事俱备只欠东风”最早指古代哪场经典战役	赤壁之战
“人为刀俎”的下一句	金玉其外败絮其中;人为刀俎,我为鱼肉;前人植树,后人乘凉;近朱者赤,近墨者黑
中国的森林面积共有多少	目前全国森林资源现状是:林业用地面积
诸葛亮的《诫子书》中，“非淡泊无以明志”的下一句是什么	非淡泊无以明志,非宁静无以致远
出演了电视剧《公主嫁到》中昭阳公主是香港哪位女演员	佘诗
三角形的内角和事180度，那么三角形的外角和事多少度	360
由太平洋一座无人岛屿而命名的一种泳装服饰叫做什么	比基
一个三角形三个角的角度比是1:2:3，请问最大角为多少度	1
今年欧洲杯的举办国家是乌克兰和哪个国家	北京时间07月02日
美国的第一位黑人亿万富翁是哪位有“脱口秀女皇”之称的主持人	奥普拉.温弗
什么英文表示买单时平均分担费用的制度	英文表示 AA制
地壳里存在的最多的金属元素是什么	铝~~元素符号是Al （A大写l小写）
华夏民族是在哪诞生的	“华夏”一词最早见于西周《尚书·周书·武成》,“华夏蛮貊,罔不率俾”
如何以“平常心”和“自然状态”对待评估工作	答:教学工作的水平评估应是
会吐丝做茧的蚕，它以吃什么植物的树叶为生	桑树 植物的树叶为
古代衙门或者大宅门口，都会摆放一对石头做的什么动物以镇宅	狮子哦
世界最繁忙的海上运输线是哪个	...墨西哥湾沿岸各港及通往美国中西部的内陆联合运输,是目前世界上最繁忙的航线
万里长城横跨我国多少省	9
摩纳哥公国三面被哪个欧洲国家包围	法国
我们通常所说“煤气中毒”是由于煤气中哪种气体吸入过量造成的	一氧化碳
相传清雍正时期出现的一种形似鸟笼，能远距离取人首级的暗器叫什么	血滴子,一种很恐怖的兵器
“一鼓作气，再而衰，三而竭”是哪个人论战时的名言	曹刿
著名的啤酒品牌喜力创始于哪个欧洲国家	今天,喜力行销170多个国家,成为世界世界上最国际化...它既是欧洲最畅销的品牌之一,又是美国啤酒市场销售...Jacobsen创建,以其儿子Carl为名
柳永的《雨霖铃》中，“今宵酒醒何处”的下一句是	“今宵酒醒何处”的下一句是“杨柳岸、晓风残月
在情景喜剧《我爱我家》中饰演“圆圆”的是哪位女演员	关
今天星期几	歌词下载;
著名的大三巴牌坊位于我国哪个城市	澳门7、陈奕迅的歌《红玫瑰》和它的粤语版《白玫瑰》
在东北方言中“贼漂亮”的“贼”是什么意思	东北方言表示非常的意思,还可以说成是:贼拉地漂亮.东北有的地方还可以说成:成漂亮了、可漂亮了
“爆竹声中一岁除，春风送暖入屠苏”中的“屠苏”指的是哪种饮品	在爆竹声中送走了一年,在送暖的春风中,阖家欢饮屠苏美酒“屠苏”是指屠苏酒,饮屠苏酒也是古代过年时的一种风俗
大海是什么颜色	人们常喜欢用蓝色来形容海洋
代表作有《康熙大帝》《乾隆皇帝》等小说的当代作家是谁	二月河
联想电脑的售后服务怎么样	反正我从2000年开始用联想，到现在为止自己换过N台联想，还有Sony，单位都是Dell，Acer，Sony等等，数量都是两位数的
金庸小说《天龙八部》中，段誉的母亲叫什么名字	刀白凤
“春蚕到死丝方尽，蜡炬成灰泪始干”的作者是谁	无题作者:【李商隐】 年代:【唐】 体裁:【七律】 类别:【闺情】相见时难别亦难,东风无力百花残.春蚕到死丝方尽,蜡炬成灰泪始干.晓镜但愁云鬓改
电视剧《北京青年》中饰演“任知了”的是哪位演员	王丽坤
《挪威的森林》是哪位日本作家的著名小说作品	村上春树
欧亨利的著名代表作《最后一篇树叶》中的“树叶”是哪种植物的叶子	常青藤 第八轮 刘化伟PK 冯彦明
京剧是在哪个朝代开始形成的	清末,徽班进京之后逐渐演变、融汇而成
歇后语“卢沟桥上的狮子”下一句是	卢沟桥的狮子—— 数不清
被称为“窃国大盗”的窃取了辛亥革命胜利果实的人是	袁世凯
“青苗法”是哪位北宋政治家施行的措施	王安石
五大连池风景区位于我国东北地区哪个省	黑龙江,在这个地方曾经有过很多神话传说的呢
明朝伟大航海家郑和的原名叫什么	这种说法没有依据,因为郑和船队最远到达非洲东海岸和红海沿岸,没有从印度洋进入大西洋,所以也就没有到达加勒比海
代表作有《那片海》《天亮了》我国内地实力派女歌手是谁	女歌手 韩红
著名女词人李清照的名句“常记溪亭日暮”的下一句是什么	答案为D
被称作东方威尼斯的是哪座城市	苏州,古称吴、吴都、吴中、东吴、吴门,现简称苏
磁通量的单位是什么	韦伯(wb)
单词“worked”中，“ed”表示什么时态	过去时
87版《红楼梦》中林黛玉由哪位女演员饰演	陈晓旭(1965.10.29—2007.5.13),著名演员、1987年版电视剧《红楼梦》中林黛玉扮演者,企业家
《格林童话》中，小红帽是在看望谁的时候被狼吃掉的	外婆
北非最著名的沙漠叫什么沙漠	你说的那个沙漠就是鲁卜哈利沙漠,占了整个阿拉伯半岛的四分之一,整个沙漠均属典型的热带沙漠气候.中部夏季最热月均温在白昼时达70
出自《增广贤文》，反映古代读书人专心学习，“两耳不闻窗外事”的下一句是	一心只读圣贤书
俗话说，“寒”从人体哪个部位起	应该选择B 理由如下:“礼貌用语是.的表现,礼貌用语起着.的作用”这句是有问题的,应改为讲礼貌用语是尊重他人的具体表现
曹操《短歌行》中，“青青子衿”下一句是	青青子衿,悠悠我心是《诗经·郑风·子衿》中的原句,其中第一章的四句是:“青青子衿,悠悠我心.纵我不往,子宁不嗣音?”
中国第一部彩色故事片叫什么名字	1956年,由桑弧导演,由北京电影制片厂推出了新中国第一部彩色故事片《祝福》
俗话说“人怕出名”的下一句	1、人怕出名猪怕壮
青春文学作家郭敬明的成名作是哪部玄幻题材的小说	《幻城》
“moon cake”是我国传统节日吃的哪种糕点	1.Spring Festival-dumplings 2.Dragon Boat Festival-Rice dumplings 3.Mid-Autumn Festival-Moon cakes 4.Easter-Easter eggs 希望能给你帮助
唐代诗人王维在《九月九日忆山东兄弟》中描写的重阳节的习俗之一是在身上插什么植物	茱萸
歌曲《达坂城的姑娘》中“你要是嫁人，不要嫁给别人”，下一句是	一定要嫁给我
苏珊.B.安东尼哪天生日	C.A.D.B.B.A.A.C
温哥华是哪个国家的城市	温哥华是加拿大的一个城市,但不是首都
电影《新龙门客栈》中，饰演金镶玉的是哪位香港女演员	张曼玉 饰演
华清池位于陕西省的哪座城市	西安
张克帆原来是台湾哪个流行组合的主唱	红孩儿
中国第一次派运动员参加并夺得第一枚金牌的奥运会是在美国的哪个城市举行	洛杉矶
珠江流域水系支流之一的“东江”发源于我国哪个省	江西
传说中沉香“劈山救母”中的山位于陕西	“三山”又称“三神山”,“史记秦始皇本纪”载:“齐人徐市等上书,言海中有三神山,名曰蓬莱、方丈、瀛洲”
如今网球ATP单打世界排名第一的是来自塞尔维亚的哪位运动员	诺瓦克·德约科维奇(Novak Djokovic),1987年5月22日出生于塞尔维亚,塞尔维亚职业网球运动员
都梁的哪部小说被改编为由刘烨主演的同名电视剧	?血色浪漫
荷兰的首都是哪个城市	首都虽然设在阿姆斯特丹,但是中央政府、贝娅特丽克丝女王居住办公地、所有的政府机关与外国使馆、最高法院和许多组织都在海牙
蒙古国的首都是哪里	乌兰巴托 意思是“红色英雄城”,蒙古人民共和国首都乌兰巴托 (Ulan Bator) 是一座具有浓郁草原风貌的现代城
制作了向日葵，星夜的荷兰后印象派的画家是谁	印象派的 凡高
植物中会因为哪种物质二呈现出绿色	解答:解:(1)[5]液泡内含有细胞液,溶解着多种物质,有多种味道:酸、甜、苦、辣.(2)[3]叶绿体里具有叶绿素,叶绿素是植物进行光合作用的主要色素
在足球比赛中，裁判把运动员罚下场会使用什么牌	红
北美洲的五大湖中，面积最小的是哪一个湖泊	苏比利尔湖
脍炙人口的歌曲《同桌的你》由哪位内地男歌手原唱	老狼 男歌手原唱
上海简称什么	上海的简称“沪”和“申”的来历 先说“沪”
《倪焕之》是我国哪位著名作家的长篇代表作品	答案AA(《沉沦》改为《边城》)
一场NBA比赛分为4节，每节比赛多少分钟	12
哪个欧洲国家的大部分国土在“亚平宁半岛”上	意大利大部分国土在亚平宁半岛上
小品《昨天今天明天》中，宋丹丹饰演的白云将“秋波”解释为什么	秋天的菠菜
我们通常用“丧家”的什么动物来比喻走投无路的沮丧样子	狗/犬
武汉三镇包括汉口.武昌和	武汉分为七个城区，分别是江汉区、江岸区、桥口区、汉阳区、武昌区、洪山区、青山区
经典名曲《相思风雨中》原唱是由汤宝如跟哪位男歌手合作的	张学友
宋之问的《渡汉江》中，“近乡情更怯”的下句是什么	不敢问来人
与巩汉林合作了小品《如此包装》《打工奇遇》的著名小品的老艺术家是谁	赵丽蓉
在《水浒传》中，武松在哪家酒楼写下了“杀人者，打虎武松也”几个血字	话说张都监听信这张团练说诱嘱托,替蒋门神报仇,要害武松性命,谁想四个人,倒都被武松搠杀在飞云浦了
狗是怎么散热的	人类流汗是通过身体上的汗腺排出汗液,起到降温的作用
美剧《绯闻女孩》中，布莱尔的饰演者是哪位演员	莉顿·梅斯特
古龙小说《绝代双骄》中十大恶人之一，“笑里刀小弥陀”是谁	哈哈儿
绰号为“蝙蝠侠”的NBA球星，现在效力于热火队的球员是谁	肖恩-巴蒂尔
小说《平凡的世界》出自我国哪位著名作家之手	路遥
《白眉大侠》是由哪位著名评书表演艺术大师创作的评书作品	单田芳 评书作品
现效力于英超曼联队的纳尼是哪个国家的足球运动员	 葡萄牙
中国佛教四大名山是九华山，普陀山，峨眉山和山西省的什么山	中国四大名山是庐山、龙虎山、黄山及九华山
目前世界上人口最多的是哪个民族	汉族 汉族
法语里猫怎么说	chaton是小猫,爱人可以用 mon choux,mon petit choux之类的,意为:我亲爱的 送给猫的歌曲:la chanson dédié à mon chaton
第一位踏上月球的人是美国的哪位宇航员	阿姆斯特朗
春秋时一对著名的铸剑师夫妻，一个叫干将，另一个叫什么	莫邪
诗人秦观的《鹊桥仙》中，“两情若是久长时”下一句是什么	又岂在朝朝暮暮
为什么在网球比赛中，0分被叫做Ace	love在网球比赛中代表的是0分 lovegame就是让对方一分未得40:0胜一局 而lovegame ace就是用了一个ace球完成了lovegame
在电视机遥控器上，“menu”是表示什么的按钮	菜单 菜单
出演了电视剧《公主嫁到》中昭阳公主是香港那一位女演员	佘诗
花式九球是哪种球类体育运动的项目	体育运动项目分为游戏、体操、田径、球类、武术、国防体育、水上、冰雪和其他等
喜剧电影《花好月圆》中饰演沈梦溪的是哪位台湾男明星	任贤齐
四大天王是哪些人	大天王是佛教的护法天神,俗称“四大金刚”
成语“趋之若鹜”中的鹜指的是什么动物	答案应该选A. 成语的意思应该是象鸭子一样成群地争先恐后地跑去. 比喻成群的人争着去.这是个含有贬义的成语. :)
非洲国家里哪个最发达	c 号称非洲的美国,虽然也有一些西非国家比他富裕,但是从科技、政治地缘、人口、矿产资源,南非应该是非常最富强发达的国家
黑人约占美国人口的比例是多少	2010
比喻贪心不足的俗语“吃着碗里的”的下一句是什么	看着锅里的
连接黑海与地中海的唯一海峡是哪个海峡	土耳其海峡/黑海海峡
王安石的诗歌《元日》：“爆竹声中一岁除”下一句是什么	春风送暖入屠苏
吉林省的哪个城市有“北国春城”之称	长春
什么半岛恐怖分子最多	美国人说有,美国政府指出朝鲜窝藏恐怖分子并对其提出支持
鸡有几只脚	2个爪子 每个爪子上面有4个“脚趾”
我国青海省的省会是哪个城市	我国青海省的省会是 西宁
沟通南大西洋和南太平洋的通道是什么海峡	 麦哲伦海峡28、获得2012年台湾电影金马奖“最佳剧情片”
著名的九寨沟风景名胜区位于哪个省份	四川
意大利哪种皮萨饼最有名	意大利的著名特色饼读音,比萨饼还是披萨饼都是中文翻译过来的,各人的读法不同而已,目前多数读比萨饼这个读音
SHE三个成员分别出生于哪年	she的个人资料 Selina - Hebe - Ella 中文姓名:任家萱 生 日:1981年10月31日 出 生 地:台北市 血 型:A 身 高:163cm 体 重:45Kg 个 性:开朗
2005年获得劳伦斯新人奖的中国田径运动员是谁	?刘翔
电影《投名状》改编自清末四大奇案之一，请问是哪个奇案	你好,电影《投名状》的故事大纲改编自清末四大奇案之一的刺马案,故事内容和电影差不多
20世纪五十年代至九十年代，我国大多数旅客列车的车皮是什么颜色的	车皮是 绿色
经过对狗进行试验，最早提出“经典条件反射”的是哪位俄国科学家	巴甫洛夫
鞋儿破帽儿破，身上的袈裟破是哪部电视剧的插曲	济公 剧的插曲
秦皇岛是哪个省的	秦皇岛属于河北省地级
现代奥运会的创始人是谁	顾拜旦男爵 Pierre de Coubertin（1863-1937）
西班牙斗牛中，选手一般会选用什么颜色为主的布	红色
影视胜地宝莱坞所在地，著名的港口城市孟买是哪个国家的中药城市	影视胜地宝莱坞所在地,著名的港口城市孟买是印度的重要港口
“爱真的需要勇气，来面对流言蜚语”是哪位马来西亚歌手的歌曲	梁静茹
在英语中，动词用哪个字母标记	sb 全 somebody 某人sth something 某事!答案补充 V:动词n :名词adj:形容词O:受词VI:不及物动词S:主词VT:及物动词ad:副词art:冠词num:数词u:不
杜甫《登高》中，“无边落木萧萧下”的下一句是	因为无边不仅表现落木之宽阔更是诗人无限的忧愁
玻利维亚在哪	在南美洲中部 阿根廷的北方,智利的东北方,巴拉圭的西北方,巴西的西南方,秘鲁的东南方
湖南才传统戏《刘海砍樵》是属于什么剧种	花鼓戏
介绍他人卖淫嫖娼应受到哪些处罚	第六十六条 卖淫、嫖娼的,处十日以上十五日以下拘留,可以并处五千元以下罚款;...2010-08-22 嫖娼如何处罚
什么岛屿的经济最发达	吕宋岛位于菲律宾群岛的北部,它是菲律宾面积最大、人口最多、经济最发达的岛屿
歇后语：“兔子的尾巴”，下一句是什么	长不了长不了
康熙时期，中国与哪个国家签订了《尼布楚条约》	康熙时期,中国与俄国签订了《尼布楚条约》
“卡布奇诺”、“拿铁”都是哪种饮品的知名种类	咖啡 的知名种类
有“大耳朵杯”之称的圣伯莱德杯是什么国际足球比赛的冠军奖杯	欧洲冠军联赛
世界第一大岛格陵兰岛属于哪个国家	丹麦属地
佛教传入中国后兴建的第一座寺院，位于河南洛阳，号称“中国第一古刹”的是哪座寺院	佛教传入中国的具体时间和年代，现在很难考定
本帮菜是哪个城市地方菜的名称	苏浙汇就是做创新上海菜的呀,在传统上海菜的基础上还结合了国内外各个菜系的特色,很符合上海的特色——海纳百川
莎士比亚的喜剧《威尼斯商人》中著名的“四大吝啬鬼”之一的人物叫什么	夏洛克
演唱《桃花朵朵开》的马来西亚歌手陈庆祥的艺名是什么	阿
雅典奥运会男子10米气手枪金牌获得者，中国国家射击队总教练是谁	现任中国国家射击队副领队、总教练兼运动员
有“陶都”之称的宜兴位于哪个省	江苏
中国哪个传统节日又叫“团圆节”	中秋节别称:月夕、秋节、仲秋节、八月节、八月会、追月节、玩月节、拜月节、女儿节、团圆
亚当和夏娃因为偷吃了伊甸园的哪种水果而被驱逐到人间	苹果 驱逐到人间
演唱《桃花朵朵开》的马来西亚歌手陈庆祥的艺名是什么	阿
我国依法对商品施的“强制性产品认制度”是由哪三个相同的英文字母组成	CCC
新生儿的平均重量是多少	1
英文单词“is”的过去式是哪三个英文字母	was
为中国赢得首枚奥运会跳板跳水金牌的跳水“女皇”是谁	“女皇”是 高敏
乔峰是金庸哪本小说里的人物	《天龙八部》
我国的二代身份证的最后一位如果是10会用哪个字母来代替	 X
这套房间的居住面积有多大	78÷(1+20%)=65(万元)
“魂”字第一笔是横，第七笔是	横折
薄公英靠什么传播种子	蒲公英是菊科植物,我们看到的蒲公英的花实际是个头状花序,由很多的小花组成
棕色人种生活在哪块大陆	棕色人种主要分布在澳大利亚、新西兰以及南太平洋的岛屿上
香港国际会展中心坐落在香港的哪个港口旁	维多利亚港
90年代流行歌曲《我想去桂林》《大头皮鞋》的原唱者是谁	韩晓
《百家姓》中“赵钱孙李”的下一句是	周吴郑王 周吴郑王
“唐宋八大家”中，有两位是唐代人，一位是柳宗元，还有一位是谁	还有一位是韩愈
自由式摔跤以身体哪个部位着地算输	肩部
我国第一部文学理论和评论专著是南北朝时期刘勰的哪本著作	《文心雕龙》
在伦敦奥运会上因场地湿滑导致摔伤而无缘奖牌的中国女子羽毛球队选手叫什么名字	羽毛球队选手 汪鑫
体积最大的动物是什么	蓝鲸是目前世界上体积最大的动物,成年蓝鲸体长可达33米,重可达190多吨,比陆地上最大的动物大象还重10-30倍或150头牛的重量 一只成年蓝鲸体形之大
日常使用的电池上标有“AA”的是几号电池	5号电池(即AA)是电池种类之一,其一般尺寸为直径14mm,高度49mm
黄百鸣拍的鬼怪题材的系列电影是什么系列	开心鬼\\\\
成语“百尺竿头”的下句是	你好,百尺竿头,更进一步
著名的“圣索菲亚大教堂”位于现在的哪个国家	伊斯坦布尔(土耳其)
形容夫妻吵架没有隔夜仇，常会说“床头打架”，下一句是什么	床尾
周杰伦的哪首歌曲与王羲之的一篇书法作品同名	《兰亭序》
距离单位中，一公里等于多少米	1000
男性称妹妹的女儿叫什么	外甥女
一米等于几尺(市尺)	一米等于 3尺
日常生活中我们把自己动手创作制作称为的英文简称	DIY
比喻围攻这个国家是为了救那个国家，三十六计中的第二计是哪一计	围魏救赵
有清洁皮肤和治疗疾病作用的桑拿浴发源于欧洲哪个国家	芬兰
罗马尼亚的首都叫什么名字	布加勒斯特 布加勒斯特
中国有记载的古代史从哪年到哪年	最早的记录是公元前841年国人暴动,这是有确切纪年的事件
国际上用“K”表示含金量，18k金表示含金量百分比为百分之多少	24
第一支获得女足世界杯冠军的亚洲国家是哪个国家	日本
我国四大家鱼，鲢鱼、鳙鱼，青鱼和什么鱼	草
现代钢琴按形状分，主要为立式钢琴和什么钢琴	三角钢琴
澳门地区包括哪几个岛屿	澳门位于珠江口西侧,背靠珠江三角洲,由氹仔岛、路环岛和澳门半岛三部分组成.故选:C
人体的血型有哪几种	还有Rh血型（Rh阴性、Rh阳性）；JK（a-b-）血型；Lan（-）血型；M-N血型；Kell-Cellano血型；特殊ABO血型（孟买型、亚孟买血型）等等 血液内部的组成
电影《孔雀》的导演是哪位摄影师出身的电影人	有人知道电影《力王》的香港导演蓝乃才的事情么 ...主要作品有《原振侠与卫斯理》、《俾捉鬼》、《孔雀...只知他1950年生于香港,师从日本,摄影出身
京津沪渝分别于哪年被确立为直辖市	一般来说直辖市的各区都是正地级,其所辖街道办,乡镇(如北京朝阳区还辖有很多乡镇)都是正处级,郊区、新区和县一般是副地级,也有正地级的
翻滚的翻字由多少笔画组成	十八画
西方国家说的“毕达哥拉斯定理”就是中国的什么定理	毕达哥拉斯定理一般指勾股定理 勾股定理是一个基本的初等几何定理,直角三角形两直角边的平方和等于斜边的平方
我们通常用“多少不笑百步”比喻没有自知之明的人	3
法国作家雨果的哪部长篇小说讲述了主人公冉.阿让的赎罪历程	悲剧世
深圳位于什么地方	深圳市位于祖国的南疆
成语“独占鳌头”中，“鳌头”指的是排名第几	甲冠天下,一马当先,首屈一指连中三元,天下第一
代表作有《成均馆绯闻》《屋塔房王世子》《想你》等电视剧的韩国男艺人是	朴有天
陇海铁路是从江苏连云港通往哪个城市的铁路干线	兰州 的铁路干线
在缅甸和泰国，皇室出行为了表示尊贵，出行时会骑在哪种动物的背上	大象
葡萄牙航海家迪亚士发现的好望角在最初叫什么角	风暴角
在越战期间，美国哪位运动员因拒绝服兵役而被剥夺拳王称号	穆罕默德·阿里在越战期间,他拒绝加入美国军队服役
金庸小说《倚天屠龙记》中，紫杉龙王的女儿叫什么名字	小昭
为什么必须血型相同才能输血	因为人体有免疫功能，如果不同血型的话，会产生免疫排斥，导致溶
在鸿门宴上多次示意项羽杀掉刘邦，又指使项庄舞剑进行行刺的谋士是谁	秦末农民战争中为项羽主要谋士,被项羽尊为“亚父”
急救电话号码是多少	12001190
雅典奥运会与2004年哪天到哪天举行	第28届夏季雅典奥运会于2004年8月13日至29日在希腊首都雅典举
王翰的《凉州曲》中“葡萄美酒夜光杯”的下一句是什么	凉州词 唐-王翰 葡萄美酒夜光杯, 欲饮琵琶马上催. 醉卧沙场君莫笑, 古来征战几人回. 都是原句
《星条旗永不落》是哪个国家的国歌	《星条旗永不落》(The Stars and Stripes Forever),美国国家进行曲
代表作《玩的就是心跳》、《顽主》等，以调侃为其语言最大特色的作家是谁	王朔
电视剧《甄嬛传》里饰演女主角“甄嬛”的是我国内地哪位女明星	孙俪
申请小型汽车驾照必须在18周岁以上，多少周岁以下	18
第五十一届世界乒乓球团体锦标赛在哪个欧洲国家举行	德国 国家举
俗话说“公说公有理”，下一句是	婆说婆有理
苏轼的词《江城子.密州出猎》中，“亲射虎，看孙郎”中的“孙郎”指哪一位三国人物	孙权曾骑马射虎,马被虎抓伤,他用长枪投刺,虎被吓退,此处是苏轼以孙权自比
宋氏三姐妹中的宋霭龄的丈夫是哪位民国时期的著名人物	孔祥熙
足球运动员宣布“挂靴”，表示什么意思	"挂靴"一词由"挂冠"转义而来,顾名思义,即把球靴挂起来,再也不穿了
大陆漂移假说是什么时间提出的	1910年的某一天,德国气象学家魏格纳(公元1880
机动车驾驶人计分达到多少分且拒不参加交管部门的学习和考试，驾驶证会被吊销	1
我国春秋时期哪位先贤发现了小孔成像原理	墨子
杭州名菜西湖醋鱼的别称是什么	宋嫂
统计法在现代社会中的重要作用有哪些	主要有两大作用: (一)有效地、科学地组织统计工作,推进统计工作的现代化进程
著名NBA球员勒布朗詹姆斯目前是效力于哪那支球队	迈阿密热火
我国一级保护动物，并与一款奶糖同名的是哪种猴类	金丝猴
计算机的主频是多少	1
三角函数中cos表示余弦，请问sin表示什么	是在直角三角形中,sin是对边比斜边
《权利法案》是哪国革命中的重要法律文件	英国的重要法律文件
碳酸氢钠的水溶液，含有弱碱性，饮用可中和人体内酸碱平衡的水俗称什么水	苏打水
在2012年伦敦奥运会中，获得乒乓球女子单打冠军的人是谁	2012年伦敦奥运会中国乒乓球参赛运动员名单一览: 男选手:王皓、张继科、马龙 替补:许昕 女选手:李晓霞、郭跃、丁宁 替补:刘诗雯
名茶“毛峰”以哪座名山出产的为最佳	黄山
盛产石油的中东国家伊朗首都是那座城市	求助:中东地区有哪些国家,各个国家分别有哪些主要城
青海湖的海拔高度是多少	3195
范仲淹名篇《岳阳楼记》中的岳阳楼在我国哪个省	湖南哦
办理个人身份证须携带什么证件到户籍管理处办理	户口本
世界名曲《欢乐颂》是贝多芬第几部交响曲中的篇章	第九 第九 第九
现效力于NBA湖人队的小前锋“慈世平”改名之前叫什么名字	罗恩•阿泰斯特10、“反身、转体、臂立”是哪个体育项目的动作术语?跳水11、金庸小说《倚天屠龙
在2012年NBA总决赛中，三届最有价值球员谁终于实现了职业生涯的总冠军梦想	当然是小皇帝勒布朗.詹姆斯了,那时他还是热火队三巨头之一,王牌儿啊!
电影《杨门女将之军令如山》中扮演佘太君的是哪位香港女明星	郑佩佩
“南锣鼓巷”是我国哪个城市的最古老的特色历史文化街区之一	北京
当今世界传播最广、信徒人数最多的是哪个宗教	信徒最多,规模最大,传播最广的肯定是基督教了
《西游记》中，猪八戒使用的武器叫什么名字	猪八戒使的兵器名为“上宝沁金钯”,俗称“九齿钉钯”,是玉帝钦赐的宝物
曾经获得24年世界冠军并于2008年举行海上婚礼的是我国哪位乒乓球女运动员	王楠
金庸的十五部小说，哪部未被收进对联“飞雪连天射白鹿，笑书神侠倚碧鸳”	古龙小说--对联 《古龙70部小说之五对联》 一 洗(碧血洗银枪) 剑(湘妃剑) 浣(浣花洗剑录) 花(护花铃) 新(新月传奇) 月(月异星邪) 残(残金
“跟我走吧，天亮就出发”这首《快乐老家》的原唱是哪位内地女歌手	原唱是 陈明
我国历史上哪个朝代的疆土地域面积最大	元朝,元朝中国历史上,领土最大的时候是在元朝,元朝不仅对外关系空前发展,由亚洲推广到欧洲和非洲,而且它的疆域辽阔广大,在我国历史上是空前的
1990年10月8日，中国内地第一家麦当劳餐厅在广东省的哪座城市开业	深圳 深圳
成语“眼观六路”的下一句是什么	你好,很高兴回答你的问题这个成语是【眼观六路,耳听八方】
本轮欧债危机最主要的导火索是哪个欧洲国家	希腊
我国自主研制并发射的首个月球探测器叫什么名字	嫦娥一号卫
美国国家美式足球联盟的年度冠军赛叫什么名字	C C光怪陆离:形容奇形怪状,色彩繁杂;比喻事物离奇多变
因淮南王刘安主持撰写而得名的一部西汉时期的论文集是什么	淮南子/淮南鸿烈/ 刘安子
王平现在多少岁了	5
戏曲及小说《杨家将》中，穆桂英是杨家将中谁的妻子	没有
“出师未捷身先死，长使英雄泪满襟”是出自杜甫哪部作品中的名句	“出师”句指的是诸葛亮为了伐魏,曾经六出祁山的事
《西游记》中的唐僧是哪位神仙转世而来	金蝉子
北约包括哪些国家	北约成员国现已达26个
哪个月最热	北半球大陆:最冷1月,最热7月北半球海洋:最冷2月,最热8月南半球大陆:最冷7月,最热1月南半球海洋:最冷8月,最热2月因为地球像一口大锅,太阳像火
我们常说“不吃什么肉惹身臊”	羊肉 惹身臊
电影《赤壁》中，林志玲的经典台词“萌萌，站起来”，请问“萌萌”是一直什么动物	萌萌”是 马
ADSL的速度能达到多少	4
世界上面积最大的湖是哪个	1、里海(中亚):虽然叫海,但不是海,是最大的湖泊,同时也是最大的咸水湖 里海(Caspian Sea)是世界最大的内陆湖,位于辽阔平坦的中亚西部和欧洲东南端
“杏林春满”和“誉满杏林”，“杏林”是称颂哪种职业的人	应该是老师,我们俗称的“园丁”
电影和电视剧的职员各有哪些职责	这个问题我也一直在和网友们探讨
儿歌《蓝精灵》，蓝精灵齐心合力打败了哪个巫师	格格巫
我们吃的胡萝卜是植物的哪个部分	食用部位是肉质根,不是茎的部位
美国历史上第一所高等学府是哪个学校	美国历史上第一所高等学府是哈佛大学
总长度约为42公里的长跑我们称之为什么运动	 马拉松 第二轮 梁倩—刘诚杰
连接红海与亚丁湾海峡是什么海峡	曼德海峡
寓言故事“刻舟求剑”讲的是春秋战国时期哪个诸侯国人的故事	“刻舟求剑 ”是《吕氏春秋·察今》吕不韦记述的一则寓言,说有个楚国人,坐船渡河时不慎把剑掉入河中,他在船上用刀刻下记号,曰:“这是我的剑掉
经典游戏《超级玛丽》中，玛丽兄弟中的弟弟在游戏中戴着什么颜色的帽子	那个名字很傻 恐龙快打
三国时期，以少胜多的大型战役有官渡之战，赤壁之战和什么战役	夷陵之战
NBA球员卡梅隆·安东尼是从哪只球队转会至纽约尼克斯队的	丹佛掘金
1939年毛主席针对大生产提出的口号“自己动手”的下一句是	丰衣足
水温最高的海是哪个	在相同的太阳辐射条件下,海洋表面和陆地表面温度的变化有很大的不同.纬度相同的地方,在夏季,海洋上气温低些,陆地上
明朝的首都在今天叫南京，而在当时叫什么	应天
卜学亮的《子曰》中“孔子的中心思想是个什么字”	孔子的中心思想是 仁
拍摄过电视剧《永不瞑目》《奋斗》《男人帮》等剧的是我国哪位导演	赵宝刚
我们平时所说的美国的“德州”是对美国哪个州的简称	德克萨斯州
内地童星金铭在8岁时拍摄的第一部琼瑶电视剧是什么	婉君
丹江是哪条河的支流	丹江，古称丹水、淅水、粉青江、黑江，是流经陕西省、河南省和湖北省的一条河流，为汉水的支流
世界上最后一个独立的殖民地，旧名西南非洲的是哪个国家	1990年3月21日晨零时,非洲大陆最后一块殖民地纳米比亚庄严宣告独立
俗语“嫁出去的女儿”的下一句是什么	泼出去的水
副主席每届任期多少年	《中华人民共和国宪法》第七十九条规定，国家主席、副主席每届任期为五年，连续任职不得超过两届
中国四大石窟之一的“麦积山石窟”位于我国哪个省	甘肃
《三国演义》中“官渡之战”中交战双方的指挥官分别是	袁绍曹操
《红楼梦》中金陵十二钗中的四春是指：元春、迎春、惜春和谁	探春
百合的别名是什么	别称:强瞿、番韭、山丹、倒仙
老子的著名思想"天法地，地法人，天法道"的下一句是什么	“人法地,地法天,天法道,道法自然
人们常说“蓬莱仙境”中的“蓬莱”位于哪个省	山东
奥运火炬是纪念谁	1936年柏林奥运会首次在希腊奥林匹亚首次举行了圣火点燃仪式和火炬传递
体坛双胞胎“李大双”“李小双”从事的是什么项目	体操哦
美国经典战争电影之一《拯救大兵瑞恩》中的“Ryan”是由哪位著名男影星饰演	马特达蒙
故宫乾清宫上的牌匾“正大光明”四字最早是由哪位清代皇帝所书	顺治
连接红海和亚丁湾的是哪个海峡	曼德海峡
比目鱼吃什么	鱼和虾都行,可以加点菜,也可以网购专门的饲料,最主要的是要注意喂养的方式,如什么时候要日晒,一天换几次水,这些在网上都搜得到的
军事上的“飞毛腿”指的是哪种武器	指的是 导弹
我国南北朝时期北朝建立的第一个朝代是什么	南朝第一个王朝就是刘裕所建立的宋朝,其后就是齐,梁,陈
地球为什么会自转	在地球形成的初期，各种尘埃围绕地心都有一个微小的角动量，在万有引力作用下，尘埃逐渐向地心聚集
秦朝后面是什么朝代	. 秦朝 前221年 - 前206年 . 西楚 前206年 - 前202年 . 汉朝 前206年 -
灭亡南宋，建立了幅员辽阔的元朝的皇帝是谁	元朝的皇帝 忽必烈
我们常说的“一打”啤酒是指多少瓶啤酒	一打:十二个为一打
9的立方是多少	9
在金庸武侠小说中，丐帮帮主所持的棍棒被称为什么	打狗棒
王维《相思》中，“愿君多采撷”的下一句是什么	此物最相思
诗歌《浪淘沙令》中“独自莫凭阑，无限江山”的下一句是	浪淘沙令 帘外雨潺潺,春意将阑. 罗衾不耐五更寒. 梦里不知身是客,一晌贪欢. 独自莫凭栏,无限江山, 别时容易见时难. 流水落花春去也,天上人间
《套中人》《小公务员之死》的作者是哪位著名讽刺小说家	契诃夫
全球最大的连锁超市叫什么	沃尔玛
吃饭要细嚼慢咽，米饭的哪种成分会被唾液中的酶分解为麦芽糖	淀粉
《金太狼的幸福生活》中，李小璐饰演的是哪个角色	李小璐饰演的角色是米小米
电视剧《西游记》中猪八戒的法号是什么	悟能哦
如果发生火灾该怎么办	1、要镇定,要了解一点,大部分在火灾中丧生的人都不是烧死的,而是被烟熏死的
世界环境日是哪天	6月5日
扶桑和东瀛指的是哪个亚洲国家	日本
意大利位于欧洲南部三大半岛中的哪个半岛上	亚平宁半岛
台湾歌手张雨生的成名曲是哪首歌	我的未来不是梦
旧时在母亲怀孕时就为子女定下婚约用哪个四字成语来表示	指腹为婚
我们说“12点一刻”的一刻是指多少分钟	15
2005年的春节是阳历哪天	2月8日
公认为四大时装周之首的时装周在哪个城市举办	公认为四大时装周之首的时装周在哪个城市举办? 米兰
俗话说“常在河边走”的下一句是什么	?哪有
大选究竟具体指什么	campaign trail 竞选活动trail [treil]n.踪迹,小径,尾v.拖,尾随,追踪Trail:障碍检验赛|余波|痕迹T_Trail:轨迹X-Trail:奇骏|日产|奇峻
曹植的《七步诗》中“本是同根生”的下一句是什么	典故出自南朝刘义庆的《世说新语-文学》:文帝尝令东阿王七步作诗,不成者行大法
英语中睡觉与某种动物发音谐音，所以失眠者经常数什么动物	羊 sleep
目前男子110米栏的世界纪录保持者是谁	楼兰
空气中含量大约占百分之七八十的是哪种气体	氮气
津巴布韦的首都在哪	哈拉雷( Harare) 旧称“索尔兹伯里”
由明朝科学家宋应星编纂，世界上第一部关于农业和手工业生产的综合性著作叫什么名字	宋应
《金石录》是由李清照和哪位金石学家一起撰写的	 赵
唐代诗人王之涣的《登鹳雀楼》中，“欲穷千里目”下一句是	多高并不重要,重要的是,上越高的楼,看的就越远!
“东和孙权，北拒曹魏”是哪位三国时期蜀国谋士的主张	诸葛亮
有“桑巴军团”之称足球国家队是哪里	辛苦了 这个很有用 收藏了 谢谢
“出来混，迟早是要还的”是出自哪部香港警匪电影系列中的经典台词	《无间道》
哪种设备功率大耗电少呢	关键还是看两者的乘积.由W=Pt可知,耗电量等于功率*时间对于上面的例子,大功率电器耗电:1.5kW*0.25h = 0.325 kWh 即0.325度电小功率电器耗电:1kW*
著名的贤后长孙皇后是唐朝哪位皇帝的皇后	长孙皇后!她是历史的贤后之一,她是唐太宗李世民的皇后!我本人也很敬重她! 长孙皇后(600—636),长安人,祖先为北魏拓
在江苏卫视热播《活佛济公三》中饰演广亮大师的是谁	林子聪
美人鱼雕像在丹麦的哪个城市	哥本哈根
琼瑶小说《还珠格格》的故事发生在哪位皇帝执政时期	乾隆
2012年与梁振英共同竞选香港特首失败的是哪位官员	唐英年
通常电脑上面的“delete键”有什么作用	1.删除 2,word编辑时能删除光标后的字符,backspace退格键删除光标前字符 3.开机时按del键某些电脑可以进入bios设置电脑开机读取等主板信息
“两河流域”是指底格里斯河和什么河	幼发拉底河
歌曲《那女孩对我说》的原唱是哪位歌手	黄义达
树林在日照下主要释放的是哪种气体	氧气
世界最深的洼地在哪里	死海是世界最深的洼地,水面平均低于海平面约米,位于以色列和约旦之间,是一个内陆盐湖,它的最低海拔是-米
比喻处理问题不从全局考虑的成语“头痛医头”的下半句	脚痛医脚
“闯关东”是过去社会的一种习俗，那么“关”指的是什么关	“关”指的是 山海关
朝鲜现任领导人金正恩的妻子叫什么名字	李雪主
上海、宁波、义务方言中的“阿拉”是指什么	我(我们)
《天仙配》是我国安徽地区哪个剧种的代表性选段	 黄梅戏
世界上最后进入元旦的国家	世界上最后进入元旦的是位于日界线东侧的萨摩亚群岛，他和最先进入元旦的汤加（位于日界线西侧）相比晚了整整一天
以热情，爆发力著称的弗拉明戈舞成型于哪个欧洲国家	西班牙
《封神演义》中，周文王是在哪条河边上碰到了钓鱼的姜太公	周文王姬昌 姜太公又称姜尚,字子牙,东海上人
夏季奥运会开幕式代表团永远第一个入场的是哪个国家	希腊
什么体育比赛第一次是在1903年开始的	美国职棒大联盟(MajorLeagueBaseball,简称MLB),是美国最著名的职业棒球联赛
俗话说“踏破铁鞋无觅处”的下一句是什么	得来全不费工夫
美籍华裔歌手李玟《想你的365天》曾作为中国哪部经典动画电影中的插曲	《宝莲灯》 的插曲
顾秉林是哪个大学的校长	　　许智宏:北大校长,男,汉族,1942年10月出生,江苏.无锡人,1965年9月参加工作,1976年2月入党,研究生学历
CBA历史上获得总冠军次数最多的是哪支球队	八
中国古代哪位曾被称为“药王”	孙思邈
计算机学报的简写是什么	IT是信息技术的简称,Information Technology,指与信息相关的技术.IA是Information Appliance的缩写.什么是信息家电呢?简单来说,信息家电是指各种具有连接国际
在陈凯歌电影《无极》中饰演“昆仑”的是韩国哪位男明星	张东健
昆明湖和万寿山在哪个著名景点里	颐和园
《明朝那些事》原书作者是谁	石悦
哪位唐朝着有《使至塞上》的“山水田园派”代表诗人因为精通佛法被后世称为“诗佛”	王维(701年-761年),字摩诘,汉族,祖籍山西祁县,唐朝诗人,外号“诗佛”
《山居笔记》是我国哪位现代作家的散文集	余秋雨
曹操“挟天子以令诸侯”中的“天子”指的是汉朝的哪位皇帝	汉献帝
新年元旦在几月份	农历新年的第一天.就是现在的春节 元旦的由来之一 每年公历的1月1日，人们称它为"元旦"，这是为什么呢? 原来在汉语里，"元"是开始，也就是第一;"
新婚吉庆时，通常会在新房贴上哪个字来讨好彩头	喜(双喜) 讨好彩头
雨果小说《巴黎圣母院》中的男主角，钟楼怪人的名字叫什么	院门前的畸形儿,被称为长相丑陋又聋的钟楼怪人
位于美国和加拿大交界处的世界上最大瀑布之一的瀑布叫什么	尼亚加拉
歌曲《海芋恋》《王子的新衣》的原唱者是哪位台湾著名男歌手	萧敬腾
演唱了《乡恋》《难忘今宵》的著名歌唱艺术家是谁	李谷
中国最早的敞肩拱桥的桥名是什么	第二个是赵州桥,第三个是长江大桥
意大利的旅行家马可·波罗在元朝哪个皇帝在位时来中国	忽必烈 .... 忽必烈
北京奥运会开幕式倒计时中由2008个人击打的乐器叫什么	击打的乐器 缶
什么食物不容易煮熟	你快对了.水的沸点低,假设80摄氏度水就开了,然后水加热食物,比标准气压的水100摄氏度,煮东西就难熟了
汉高祖刘邦曾在秦朝时于沛县泗水郡担任什么职务	 ——
我们通常以哪条运河作为南美洲与北美洲的分界线	巴拿马运河
龚自珍《已亥杂诗》中，“落红不是无情物”的下一句是什么	落红,本指脱离花枝的花,但是,并不是没有感情的东西,即使化做春泥,也甘愿培育美丽的春花成长.在这并不特指某一种花~而是概称
我国第一座完全由中国自行设计和施工的长江大桥建于哪个城市	南京
著名的贞观之治发生在哪个朝代	唐朝
NBA华盛顿奇才队在2010年选中的状元叫什么名字	约翰沃尔 ,华盛顿奇才
我国第一部水文地理专著是什么	我国第一部水文地理专著是:水经注
在象棋棋盘中间有四个字分别是“楚河”和什么	(1)刘邦、项羽的军事分界线
近期上映的东方魔幻爱情电影《画皮2》是由哪位导演指导的	 乌尔善 第十轮 李洋PK李志芳
ibm的全称是什么	IBM(International Business Machines Corporation),国际商业机器公司,或万国商业机器公司的简称
可以做净水剂的铝盐是什么	铝盐水解产生氢氧化铝胶体,胶体有净水的能力而直接得到的氢氧化铝颗粒比较大,不具备胶体的特点(1~100nm),不具备净水能力,就是一种沉
曾被网友称为“校园文学第一奇书”的《草样年华》的作者是谁	?孙睿
世界上最长的河是什么河	尼羅河是上源的白、青??l尼羅河在蘇丹首都喀土穆?R合後的正式稱
有“音乐之都”美誉的维也纳是哪个国家的首都	奥地利
男人的生育年龄段是多少	70
清华的校址是多少	重庆市渝北区回兴工业园区
单一民族国家有哪些	一楼的都错了 只有韩国，人口大约4000多万，其次是朝鲜有2000多万人口，他们都是朝鲜族
我们平时所说的“中传”是我国那个信息传播的最高学府简称	中国传媒大学
被称为世界五大宫殿之一的凡尔赛宫曾是哪个欧洲国家的王宫	被称为世界五大宫殿之一的凡尔赛宫曾是哪个欧洲国家的王宫? 法国
机器猫哆啦A梦是大雄的哪位亲属派过来保护他的	大雄的孙子
火箭队队员麦迪近期和CBA哪支球队签约	青岛队
常言道“师傅领进门”的下一句是什么	修行靠个人
由张之洞创办的我国最早的官司办钢铁企业叫什么	汉阳钢铁
代表作有《那片海》《天亮了》我国内地实力派女歌手是谁	女歌手 韩红
矿泉水和果汁哪个容易结冰	假设矿泉水容易结冰, 所需器材,量杯,矿泉水,果汁,烧杯,停表
“左三圈右三圈脖子扭扭屁股扭扭”是范晓萱的什么歌	健康
历史上说的“江郎才尽”中，“江郎”叫什么	江淹
我们用三只脚的什么动物来形容那些技艺上略知皮毛而不甚精通的人	猫
“非洲屋脊”是哪个国家的别称	埃塞俄比亚 埃塞俄比亚位于非洲东部,地处红海西南的东非高原上,为内陆国家
《三国演义》里因其捉曹操又放曹操，并又与曹操一起逃亡的是哪位谋士	陈宫 陈宫
贾平凹最著名的描写当代知识分子生活的世情小说叫什么	废都哦
哪位日本作家以《国学》《古都》《千纸鹤》三部代表作，获得诺贝尔文学奖	(1)川端康成(2)警世通言(3)出师一表真名世　千载谁堪伯仲间　出师未捷身先死　长使英雄泪满
被看作西藏人的护卫犬和保护神，并有东方神犬称号的是什么	称号的是 藏獒
Windows操作系统的几个版本分别于哪年发行	1985年Windows 1.0正式推出
为什么太阳看上去是黄色的	大气中的尘埃会散射短波的光,就是蓝紫光(天空看起来是蓝的就是这个原因),这样太阳光中的蓝紫光就少了,因此看来是偏黄色的
相传镇压白娘子的雷峰塔位于哪个城市	雷峰塔在杭州
人体缺少哪种微量元素会导致骨质酥松	解答:解:钙能使骨骼和牙齿具有坚硬的结构支架,缺钙会得骨质疏松、佝偻病和发育不良.故选A
“百老汇”是什么建筑的名字	"百老汇"是一条街的名字
一款得名于关羽在赤壁之战后放走曹操的地名的益智游戏叫什么	华容道 华容道
我国国酒茅台酒出于哪个省份	贵州
汉朝存在的时间范围是多少	秦朝
俄国作家果戈里在名著《死魂灵》中塑造的经典吝啬鬼人物，叫什么名字	泼留希金
绿茶精品“碧螺春”原产自江苏哪个城市	苏州
1713年，清朝哪位皇帝封五世班禅为“班禅额尔德尼”	康熙
中国股票市场用红色表示涨，用什么颜色表示跌	中国股票市场用红色表示涨,用绿色表示
“辛酉政变”是发生在当时那位清朝皇帝逝世后的宫廷政变	咸丰
在《铁齿铜牙纪晓岚》中将和珅演的惟妙惟肖的是哪位演员	王刚 王刚
在五行相生中，水生什么	五行相生: 金生水,水生木,木生火,火生土,土生金
金庸小说《天龙八部》中人称“大轮明王”的吐蕃国国师的名字是	鸠摩智
有“高原之舟”之称，生活在海拔最高处的哺乳动物是什么牛	哺乳动物是牦牛
最近有什么连续剧好看	神医信义,拥抱太阳的月亮都不错
歌手玛当娜的真名是什么	关·史蒂芬妮(Gwen Stefani)
我国的第一部诗歌总集是	诗经是我国的第一步诗歌总集
三国时期，以少胜多的大型战役有官渡之战，赤壁之战和什么战役	夷陵之战
草原在哪座山旁边	去长白山天池
谷氨酸钠是我们常用的哪种调味品的主要成分	味精的主要成分
JOLIN是哪位台湾著名女歌手的英文名	蔡依林 蔡依林
“子美”是哪位唐朝大诗人的字	 郭松林字子美,何绍基以此送他十个字:古今三子美,前后两汾阳.上联叩"子美".唐诗人杜甫字子美,宋诗人苏舜钦字子美,与他合为三子美
庄子的《秋水》里传说中的黄河之神叫什么	河伯
于谦诗歌《石灰吟》中，“千锤万凿出深山”的下一句是	烈火焚烧若等闲
被誉为“红军”的是哪一支英超俱乐部	利物浦
俄罗斯名城“斯大林格勒”现在叫什么名字	伏尔加格勒
“池塘边的榕树上，知了在声声叫着夏天”是罗大佑的哪首经典歌曲	《童年》
沟通大西洋与地中海的海峡是什么海峡	直布罗陀海峡Strait of Gibralter
“傅文佩你别躲在里面不出声我知道你在家”是琼瑶哪部剧中雪姨的台词	情
奥林匹克运动会发源地在哪里	希腊雅典
法国作家儒勒.凡尔纳被称为什么	儒勒·凡尔纳（Jules Verne，1828年-1905年），法国小说家，科幻小说的开创者之
1869年，俄国的科学家门捷列夫发明了哪个揭示物质特性的列表	元素周期表
香水擦在什么部位最动人	香水不能直接喷在衣服上，而应该直接喷在身体上
洋快餐麦当劳的招牌是一个什么英文字母	M
2010年12月起，儿童身高在多少以下火车票免票	1
石油的用途是什么	石油又称原油,是从地下深处开采的棕黑色可燃粘稠液体
俗话说“一夫当关”，下一句是什么	万夫莫
英文单词“us”是哪个单词的宾格	we
单词“have”的第三人称单数形式是哪个英文单词	go 的第三人称是goeswalk的第三人称是walkshave的第三人称是has
演艺圈夫妻成龙和林凤娇的儿子叫什么	房租名
20世纪90年代流行歌曲《纤夫的爱》由于文华和哪位男歌手搭档演唱	尹相杰
疏伐的行距以面积多少乘多少最好	1
《红楼梦》中，为贾宝玉病补雀金裘的是他的哪位丫鬟	晴雯 晴雯 晴雯
作品有《大阪城的姑娘》等作品，被称为“西部歌王”的音乐家是哪位	王洛宾
腐败的拼音缩写是什么	腐败的简称.呵呵....吃喝玩乐的代名词. “FB(腐败)”是网上常见的一个专用词
美国国会实行两院制，一个是参议院，另外一个是	众议院
新浪网的标志是以哪个五官部位为原型的	眼睛
曾单人《浮沉》、《沉默的证人》、《人证》男主角的我国内地著名影星是谁	王志飞
龙门石窟在哪个省	河南
被俄罗斯人民称为“母亲河”的是哪条河流	伏尔加河
出自王勃的诗句“落霞与孤鹜齐飞”的下一句是	,巧化成句,别出新意
“身在曹营，心在汉”说的是三国时期哪位著名武将	关羽
“其实地上本没有路，走的人多了，也便成了路”是哪位作家说的	脚印是我们将要留给后人的财
中国海岸线的北起端点在哪	中国海岸线总长度约3.2万公里，居世界第八位，其中大陆海岸线1.8万公里，岛屿海岸线1.4万公
在清代皇宫中“福晋”一词是什么称谓	妻子 称谓
BBS是什么的简称	BBS 电子布告栏系统 n. 全称Bulletin Board Service,同bbs,电子公告板系统,国内多称论坛
现任朝鲜领导人金正恩的父亲是谁	金正恩: 父亲金正日 爷爷金日成 哥哥金正男
孙雯领军的中国女足在世界杯上的最好名次是第几名	1999
代表作有《边城》，出生于湖南凤凰县的著名作家是谁	边城描写的是湖南省花垣县茶洞镇
影视剧中客栈的客人会称呼站在柜台中算账的店主为什么	掌柜
《三个Acup的女人》，《我在云上爱你》出自于哪位香港著名言情小说家	面包树系列 《面包树上的女人》 《面包树出走了》 　 《流浪的面包树》 都市爱情系列 　　《三个A CUP的女人》 　《是谁拿走了那一双雪靴》
中共哪天成立	1921年盛夏的一个晚上,上海法租界望志路106号一幢砖木结构的两层小楼里,透出明亮的灯光,一张长方桌周围13位代表在开会
日本动漫《火影忍者》中，宇智波佐助的哥哥是谁	第355话、336话开始打,到第360话结
皇帝颁布的旨意叫“圣旨”，那么皇后和太后颁布的旨意叫什么	太子、王爷、公主的旨意叫谕
历史上说的“五代十国”是介于哪两个朝代之间的历史时期	唐宋
请问创意经济在建筑行业有哪些应用啊	广告 景观 设计
“蝴蝶飞啊，飞向未来的城堡”这句歌词出自台湾哪个偶像团体的歌曲	 小虎
哪位隋末叛军首领，在禁卫军兵变时弑君隋炀帝	宇文化及
《巴黎圣母院》中被敲钟人卡西莫多救起的吉普赛少女叫什么名字	1、《巴黎圣母院》中的丑陋的敲钟人:卡西莫多
俗语“一窍通”下一句是什么	百窍通
世界上面积第二大的国家是哪个北美洲国家	楼上的加拿大是世界第二大北美洲第一大的啊 北美洲面积第二大的是美国
中式英语“people mountain people sea”直译成中文是哪个成语	人山人海
号称“人屠”的是我国战国时期哪一位秦国名将	公孙起
中国最大的沿海群岛是位于浙江省的哪个群岛	舟山群岛 舟山群岛 舟山群岛 舟山群岛
2006年正式宣布退役，现任中国女子乒乓球队教练的是哪位著名运动员	孔令辉
一般用什么动物大开口来形容开价或提出很高的条件	狮子
与柳公权并称为“颜筋柳骨”的著名书法家颜真卿是哪个朝代的	√
我国“十五”时期经济社会发展取得哪些辉煌成就	C 党的领导有政治领导、组织领导、思想领
红军二万五千里长征的终点是哪个省	路程未明:通常是二万五千里.但有可能
WTO是哪个组织的称呼	世界贸易组织的英文简称
围棋是发源于中国的传统智力项目，它的最高级别是几段	9段
网球运动中最古老和最具声望的赛事温布尔登网球公开赛是在哪个城市举办的	?伦敦
拉丁美洲中，面积最大的是哪个国家	2 巴西联邦共和国国名:巴西联邦共和国(The Federative Republic of Brazil,República Federativa do Brasil) 一.【巴西概况】巴西作为葡萄牙的殖民地长达
被称为“天下第一湾”的亚龙湾在海南省的哪座城市	三亚
夜晚在路边可以看到的五颜六色的灯被通称为什么灯	霓虹灯
成语铁杵磨成针讲的是关于哪位唐代大诗人的故事	成语铁杵磨成针讲的是关于哪位唐代大诗人的故事? 李白
中国戏曲脸谱中，以曹操为代表的阴险狡诈的人物通常画什么颜色脸谱	白色的啦
奥运五环是谁构思设计的	按照传统的说法，这个标志的设计者，是现代奥运会的创始人皮埃尔.德.顾拜旦男爵，于1913年设计的
哪个城市有“北国春城”之称	长春 长春
周星驰电影《大话西游》中能穿越时空的宝物叫什么	月光宝盒
1980年，吕良伟版的香港电视剧《上海滩》中，许文强的扮演者是哪位影星	周润发
唯一能参加奥运会比赛的是什么动物	1.Equestrianism is the only Olympic sport that men and women compete in the same event.2.Equestrianism is the only Olympic sport that is
各个国家的大使馆都在中国的哪座城市	北京
新疆地区有“三山夹两盆”，其中的三山指的是阿尔泰山、昆仑山和什么山	天山 天山
《伤寒杂病论》是东汉末年哪位著名医学家的著作	张仲景
被称为沛公的是汉朝的哪位皇帝	刘邦
出自刘邦项羽的典故，人民常把不怀好意的宴会称为什么宴	鸿门宴
时下把青年男女认识时间很短就结婚称作什么婚	闪婚
为歌剧《仲夏夜之梦》所配的名曲《婚礼进行曲》虽哪位著名德国作曲家创作的	门德尔松
成都的市花什么	1983年5月26日，成都市第九届人民代表大会常务委员会决定，正式命名芙蓉花为成都市市花
拿破仑在哪年颁布了《拿破仑法典》	1804年
我们把人类口腔中前面正中的牙齿叫做什么	门牙
根据世界卫生组织的划分，在全球禽流感疫情的预警机制中，哪种颜色代表最严重的级别	所谓的世界组织与禽流感事件
“大河向东流哇，天上的星星参北斗哇”这句歌词出自刘欢演唱的哪首歌曲	刘欢演唱的 好汉
中国最好的武侠RPG游戏是哪个	! 对您的话题很感兴趣!每个人都有各自的喜好,我最喜欢的是国产RPG经典,轩辕系列! 是不是我太老套啦,,哈哈 下面是我和我的一个玩友2005年发
汉文帝、汉景帝统治时期，采取“轻徭薄赋”、“与民休息”的统治史称什么	文景之治
被西方学者称为中国古代百科全书的《梦溪笔谈》是北宋哪位科学家所著	沈括
传说中的“十八铜人阵”是哪个武学门派的阵法	 少林寺
红极一时的英文歌《Takemetoyourheart》是翻唱了张学友的哪首经典歌曲	《吻别》
宋代文豪中的“三苏”是指苏洵，苏轼和谁	与其父苏洵 其弟苏辙
呼和浩特市最早兴建的喇叭教寺院是	寺院是 大昭寺
地球到火星的距离是多少	5500
醉驾入刑法例实施后，文化名人醉驾入狱的第一人是谁	高晓松
NBA球员德隆·威廉姆斯从哪支球队转会到了布鲁克林篮网队	 犹他爵士85
《增广贤文》中车到山前必有路，的下一句	船到桥头自然直
中国体操奥运冠军陈一冰的前女友是哪位中国女子蹦床选手	何雯娜
源于北方歇后语，“是骡子是马”的下半句是什么	牵出来遛遛
在NBA联盟中，底特律是哪只球队的所在地	,是世界上最大的飞机制造商波音公司的总部所在地
天府之国指哪个省市	现多指称以成都平原为中心的的富庶之地
我们经常会用川剧艺术中塑造人物的哪种物质来形容反复无常变化多端的人	?变脸
“大事化小”的下一句是什么	小事化无
写下“问君能有几多愁，恰似一江春水向东流”的南唐亡国国君是谁	“问君能有几多愁,恰似一江春水向东流
中国花样滑冰队著名的夫妻档运动员，丈夫是赵宏博，妻子是谁	申雪
除了太阳以为，距离地球最近的恒星是哪一颗	比邻星 积极的人在每一次忧患中都看到一个机会,而消极的人则在每个机会都看到某种忧患
通常指背地里向老师汇报同学的缺点的叫打什么	打小报告
1986年世界杯上演了“上帝之手”的足球运动员是谁	1986年6月22日,1/4决赛中,马拉多纳率领阿根廷队以2∶1战胜英格兰队,使他成了民族英雄
圣经故事中传说可以让世界上各种陆上生物躲避一场大洪水的大船叫什么	圣经故事中传说可以让世界上各种陆上生物躲避一场大洪水的大 船叫什么? 诺亚方
法国资产阶级革命是以巴黎人民攻占何地的起义为序幕	攻占巴士底狱的历史 多少年来,人们像痛恨封建制度一样痛恨这座万恶的巴士底狱
国家5A级旅游景区“瘦西湖”位于哪个城市	扬州
有唐三藏主持建造的大雁塔是哪个城市的著名景点	西安
美国废除奴隶制是在哪年	1862年9月,林肯发布了著名的《解放黑奴宣言》,宣布废除奴隶制,解放黑奴
英国第一部现实主义长篇小说《鲁滨孙漂流记》的作者是谁	丹尼尔.笛福
现今通用的最新版一角钱硬币的背面是哪种花卉	兰花
汉族传统婚礼中，三拜中一拜天地，二拜什么	汉族传统婚礼中,三拜中一拜天地,二拜是高
海城市在哪个省	我就是那的人,海城是鞍山市下属的县级
名著《三国演义》中，刘备在白帝城病危，将儿子刘禅托付给哪位大臣	诸葛亮
足球世界杯比赛中，每支队伍规定上场的球员首发人数是多少名	11
2004年夏季奥运会是在哪个城市举办的	希腊的雅典,创造了中国历史以来参加奥运会的最好记录
《黄河大合唱》的作曲者是谁	冼星海先生冼星海是我国著名的爱国主义作曲家.他在民族救亡的感召下,摒弃了为艺术而艺术的观念,为人生、人民而艺术
经济类的考研考哪个方向的比较好啊	首先分析自身条件:经济类的研究生是考的数3,是考研数学里面最简单的
我们通常以哪条运河作为南美洲与北美洲的分界线	巴拿马运河
央视配音版《米老鼠和唐老鸭》中，为唐老鸭配音的是谁	美国动画片《米老鼠和唐老鸭》 【原 片 名】当年央视版引进内容较杂,分属迪斯尼多个系列,现已无法考证 【出品年代】始于1928年 【出品公司】Walt
中国夏朝的最后一个君主叫什么	叫做 夏桀啊
四人帮都有谁	四人帮是指文化大革命时期的王洪文、张春桥、江青、姚文元反党集团.江青(1915年—1991年5月14日),毛泽东的第四任妻子
是一种著名中药，也是我国宁夏最著名的特产之一的是什么	枸杞
调制解调器modem一般用什么动物来称呼	猫
“吹神”曾经是哪位著名香港歌手在新浪微博的用户名	陈奕迅
在香港“狗仔队”是对从事什么职业的别称	记者
金庸小说中提到“为国为民，侠之大者”，这是他书中哪位人物说的话	金庸小说中提到"侠之大者，为国为民"，这是由书中的哪位人物提出的
飞流直下三千尺，疑是银河落九天，描写的是哪座山的景色	庐山的景色
我国最北、面积最大的原始森林是	大兴安岭
美国国务院的行政首长的职务名是	美国总统就是国务院的行政首长,国务卿其实是外交部长
维和部队是哪个国际组织建立的一支跨国界的特种部队	联合国
梵蒂冈的国家领袖被称为什么	被称为 教皇
中国男足获得2002年世界杯出线权的主场是在沈阳的什么体育场	五里河
鲜啤酒通常称为什么	鲜啤酒，也称扎啤或生啤，酒口感较好，我与朋友都喜欢喝
目前唯一在NBA打球的中国球员叫什么	易建联
“我的小时候，吵闹任性的时候。我的外婆，总会唱歌哄我”这句歌词出自孙燕姿的哪首歌	歌词“我的小时候吵闹任性的时候,我的外婆总会唱歌哄我”出自孙燕姿演唱的哪首歌曲? 歌词分享到: 专业回答滴答360
“明湖居黑妞白妞说书”出自哪部晚清小说	老残游记18、名句“易求无价宝,难得有心郎”出自哪位唐朝女诗人之手?鱼玄机/鱼幼微keleyi.cn第四轮:刘姿彤PK
由凹凸不平的玻璃做成的镜子，照起来奇形怪牡，引人发笺，这个镜子叫什么	这个镜子叫哈哈镜
世界上人口密度前两位的国家是	1.孟加拉国--人口--14737万--面积---14.40万Km2--人口密度---1023人/ Km2 2.日本--人口--12762万--面积---37.78万Km2--人口密度—338人/
哥伦布航海计划得到谁的支持才变成现实	时任西班牙君主的斐迪南国王和伊莎贝拉王后——确切地说,是后者发现了这个航海计划的价值并说服前者提供资助
男女表演者随着音乐节奏的东张西望，被阿根廷人视为国粹的舞蹈是	探戈
因六朝时期石头城遗址而有“石头城”称号的是我国现在的哪座城市	南京
埃菲尔铁塔有多高	300米高的埃菲尔铁塔是1889年为纪念法国大革命一百周年而建的纪念塔
扮演与自己性别不一样的角色，被称为什么	反串 反串
成语“风声鹤唳”最早是指那一位前秦皇帝率军溃退的狼狈状	苻坚的狼狈军
2012年伦敦奥运会男子蹦床冠军是我国哪位运动员	董栋
香港喜剧演员吴君如的老公是哪位著名导演	陈可辛 著名导演
阿胶是由驴的哪个部位熬制而成的	驴皮
亚利桑那州大峡谷是哪个国家的名胜	美国
李白的诗《长干行》中，“郎骑竹马来”的下一句是什么	青梅竹马在古装电视剧中经常见到,它通常与两小无猜配合在一起
世界最长的裂谷带是	东非大裂谷 东非大裂谷是纵贯东部非洲的地理奇观，是世界上最大的断层陷落带，据说由于约三千万年前的地壳板块运动，非洲东部地层断裂而形成
位于湖北省，有“中国道教第一山”之称的是哪座名山	武当山
由英达导演，宋丹丹、梁天、关凌等主演的中国第一部室内情景剧叫什么	我爱我家
已知的世界上最坚硬的天然物质是什么	不懂,没有任何比钻石更硬的物质了,因为金刚石就是钻石的原料
按照传统，春节时贴在窗上的剪纸又叫什么	窗花
长沙的区号是多少	0731
京剧名段《铡美案》是讲包公把哪个负心汉斩首	陈世美 斩首
以双子塔为地标的马来西亚首都是哪个城市	 马来西亚首都--吉隆坡的地标-双子塔(国家石油大厦)
诗句“欲穷千里目”的下一句是	哈!这就对了.是 更上一层楼 全面股改号角既已吹响,胜利定在最后坚持之中!而去选择悲伤..镜子的自己,竟如此的糜烂不堪,这是自己吗
周华健代表歌曲，一般也用来指责男人不专一，是哪首歌	《花心》 《花心》
港星钱嘉乐的老婆是哪位TVB女星	汤盈盈 汤盈盈
被印度人民称为“母亲河”的是哪条河流	母亲河”的是 恒河
刘翔是110米跨栏的名将，请问男子110米栏有几个栏	是2004年雅典奥运会的110米栏比赛,刘翔以12秒91的成绩平了由黑人保持11年的世界纪录,这是中国人夺得的第一枚奥运田径金
北京大学的地址在哪里	北京大学地址:北京市海淀区颐和园路5号附近公交A、海淀桥北公交站乘坐302路332路333内环333外环584路夜8路运通106线运通114线运通118线运通124线到海
吴门四大才子俗称江南四大才子是指唐伯虎，文征明，徐祯卿和谁	祝枝山
扶桑和东瀛指的是哪个亚洲国家	日本
曾演唱过《小李飞刀》《铁血担心》等歌曲的香港实力派男歌手是谁	罗文
“相见时难别亦难，东风无力百花残”是李商隐哪首诗中的名句	是李商隐《无题》中的名句,相信大家都能耳熟能详吧
国民生产总值的英文简称是什么	GDP,gross domestic production
歌词“东方之珠，我的爱人”中，东方之珠指的是哪座城市	香港
集合是什么	集合具有某种特定性质的事物的总体
蔡依林《爱情36计》的歌词中“爱情36计，像一场游戏”下一句是	爱情三十六计 歌手:蔡依林 是谁说的漂亮女生没大脑 只懂的爱美和傻笑 你看你说话的表情多么的骄傲 难道不怕我Say Sorry Get Out 是谁开始先出招没
银河系是什么	银河系是太阳系所在的恒星系统,包括一二千亿颗恒星和大量的星团、星云,还有各种类型的星际气体和星际尘埃
中国共产党的生日是哪天	　 准确地说,中国共产党的生日是1921年7月23日,党的纪念日是每年的7月1日
热干面是我国哪个城市的传统美食	热干面是湖北省武汉市的汉族特色小吃,原本是武汉的特色美食,在湖北很多地方都十分受欢迎
由哥伦比亚大学颁发，美国新闻最高奖叫什么	普利策新闻奖
金庸小说中的“降龙十八掌”的第一式叫什么名字	亢龙有海
俗话说，“水能载舟”的下一句是什么	水来伸手,饭来张口
贫血的主要原因是人体内缺少哪种元素	贫血主要原因是人体内缺少铁
中国历史上唯一一位正式签署文书离婚的皇帝是	偶寻挡颈露苹韭虑铺恃M高贵
“四大名亭”中的“醉翁亭”位于哪个省	我国四大名亭中的爱晚亭是毛泽东题的
世界上最低的湖泊“死海”位于亚洲西部巴勒斯坦和哪个国家的交界处	死海Dead Sea 死海位于亚洲西部巴勒斯坦、约旦、以色列之间，地处南北走向的大裂谷地带中段
小时候的故事“铁杵磨成针”讲的是哪位唐朝大诗人的故事	成语铁杵磨成针讲的是关于哪位唐代大诗人的故事? 李白
成语“感激涕零”中的“涕”指的是什么	涕:眼泪;零:落
英语中，名词用“n”来表示，那么动词用哪个字母来表示	动词v形容词adj 副词adv 名词n祝你天天快乐，学英语要持之以恒加油
世界级名校华盛顿大学以及星巴克总部都位于美国西北部太平洋沿岸的那个城市	太平洋沿岸的 西雅图
与书法家柳公权并称为颜筋柳骨，颜体的创立人是哪一位唐朝书法家	颜真卿
在《名侦探柯南》中，长相与工藤新一十分相似，原名为黑羽快斗的怪盗是谁	怪盗基德
在新加坡版《神雕侠侣》中饰演“小龙女”的新加坡国宝级女演员是谁	范文芳
中国西北黄土高原上居民的古老穴居式住所叫什么	窑洞
蛋白质由什么元素构成	蛋白质不含P;核酸不含S
川菜“蚂蚁上树”的主要食材是肉末炒什么	蚂蚁上树其实就是粉丝炒肉末
由先锋话剧导演孟京辉执导，讲述主人公“马路”偏执地追求爱情的话剧叫什么	恋爱的犀牛
古诗词“好雨知时节”的下一句是	好雨知时节,当春乃发生.杜甫的春夜喜雨
我国的“帆船之都”是山东省的哪个城市	济南市 鲁A 鲁w 副省级省会城市,泉城,山东第一大城市,黄河流域中心城
台湾女作家三毛的丈夫叫什么名字	他是在工作时被海水淹死的
名著《红楼梦》中怡红院是哪位男主角的住所	贾宝玉
太平天国起义开始于我国广西的什么地方	广西的 金田
人耳能听到的声音的最大频率是多少	20
非洲的沙漠面积约占整个非洲面积的多少	1
当我们说一台电脑是“486”或“586”时，这实际上是指的是电脑的哪个部件	中央处理器 1
淮海战役又称“徐蚌会战”，其中“蚌”指的是安徽哪座城市	指的是安徽 蚌埠
民间所说的“千刀万剐”指的是我国古代哪种酷刑	凌
被称为“阿胶之乡”的东阿镇位于山东省的哪个城市	东阿县属于聊城市 另外,东阿镇属于平阴县,也属于济南
保存完好前的前哥伦布时期的印加遗址马丘比丘位于哪个国家	秘鲁
在亚特兰大奥运会上夺得5000米长跑金牌的中国女运动员是谁	王军霞
我们常用哪两个字母来简称个人电脑	PC
歌曲《我不做大哥好多年》是哪位已故艺人兼特技演员演唱的	?柯受良
比尔盖茨有多少钱	528
美国现任总统贝拉克.奥巴马所属政党是美国什么党	国现任总统贝拉克奥巴马 属于民主党
《诗经》中《硕鼠》一篇，“硕鼠硕鼠”的下一句	无食我黍
杰克逊伯勒克是什么国家的人	美国人以下是迈克尔-杰克逊的主要生平简历:1958年8月29日,迈克尔-杰克逊出生于美国印地安那州的盖瑞
电影画皮的主题曲是由海豚公主称号的内地女歌手是谁	中文名:张靓颖外文名:JaneZhang国籍:中华人民共和国民族:汉族星座:天秤座血型:O型身高:162cm体重:49kg出生地:四川省成都市出生日期:1984年10月11日毕业
诺贝尔发明了什么	诺贝尔一生的发明极多，获得的专利就有２５５种，其中仅炸药就达１２９种
动物中的跳高冠军是谁	猎豹
日本著名花样滑冰选手，曾获得2010年世界锦标赛冠军，2012四大洲花样滑冰锦标赛男单自由滑亚军的选手是谁	单自由滑亚军的选手是谁
按照国际惯例，接待国家元首时要鸣放多少响礼炮	21
圣经中说，夏娃是由亚当身体的一根什么造成的	亚当身体的一根 肋骨
世界共分哪几大洲	世界分为7大洲,4大洋!第一:亚洲,第二:非洲,第三:北美洲,第四:南美洲,第5:南极洲,第六,欧洲:第7:大洋州亚洲的国家有48个国家,它们是:中国
物理学中的“质量”这个单位一般是用哪个英文字母来表示的	M 英文字母来表示的
北宋末年，金军攻破北宋都城，北宋灭亡，史称什么之变	靖康
名著《红楼梦》中，香菱的父亲是谁	甄英莲,是古典名著《红楼梦》中人物,金陵十二钗副册女儿,贾府通称香菱
“霸天虎”“擎天柱”出自哪部美国动漫作品	霸天虎”“擎天柱”出自哪部美国动漫作品? 《变形金刚》
“Physics”是我们中学时期哪门科目的英文名	chinese math english physics chemistry biology politics history geography
中国福利彩票的双色球是哪两种颜色	恭喜,是5元! 如果前面中3个后面中1个特别号就是10元!
中国是世界第几大国家	1
登机牌上印有“MU2769”的航班号，MU是指哪家航空公司	　　东方航空
西方人认为哪一个数字因和“星期五”生命时会发生不好的事而被忌讳	13
80年代著名的童星，因饰演了琼瑶剧《婉君》中的“小婉君”而一举成名的是谁	金铭
有《向日葵》等著名画作的画家梵高是哪个国家的人	荷兰
编撰了《海国图志》并且提出“师夷长技以制夷”思想的是谁	魏源
打麻将和牌时，手中的牌只由一种花色组成，通常会叫做什么	清一色
古代四大美男之一，屈原的徒弟叫什么名字	宋玉!!!
与巩汉林合作了小品《如此包装》《打工奇遇》的著名小品的老艺术家是谁	赵丽蓉
北京奥运会打破男子100米世界记录的是谁	博尔特
成语“失之毫厘”的下一句是什么	失之毫厘,谬之千里·
2012年与梁振英共同竞选香港特首失败的是哪一位官员	唐英年
《白毛女》中杨白劳唱道，“扯上了二尺的什么，给我喜儿扎起来”	红头绳
中央电视台著名节目《实话实说》的第一任主持人是谁	崔永元
DVD的全名是什么	Digital Visual Disc-Random-access memory(随机存取内存,随机存取存储器)什么是DVD-RAM?DVD-RAM这个规格,早在1997年就已经被DVD Forum 所完成确认,推出
北京大学的邮编是多少	朋友，你好
《花儿为什么这样红》是哪一部60年代的经典电影主题曲	《花儿为什么这样红》本来是一首古老的塔吉克族民歌,后来由雷振邦先生改编成电影《冰山上的来客》插曲
在足球中会以什么方式选择开球权	掷硬币 选择开球权
我们通常形容显出破绽，暴露真相叫露出什么动物脚	马脚
韩国足球队前国脚安贞焕曾效力于中超的哪支球队	大连实德
用来鉴定亲子关系的脱氧核糖核酸的缩写是哪三个英文字母	DNA亲子鉴定实验操作步骤如下: 第一步:DNA提取 把样本细胞核中所含有DNA提取出来,然后进行一定的纯化,化除样本中的杂质
陆游的《卜算子·咏梅》中，“已是黄昏独自愁”的下一句是什么	　　陆游《卜算子·咏梅》　　陆游(1125—1210) 字务观,号放翁,山阴(今浙江绍兴)人
2012年中国网球公开赛中，战胜特松加并连续三次获得中网男单冠军的人是谁	德约科维奇/小德
对流层中都有哪些气体	C 试题分析:表示数据反映温室气体增多,由于温室气体能大量吸收地面辐射,加强大气逆辐射,故使近地面气温升高,故C项正确
非洲北部国家阿尔及利亚的首都是哪座城市	阿尔及尔
我国唐代哪位高僧为了弘扬佛法，曾经六次尝试东渡日本并最终取得成功	鉴真和尚
中国1997年设立的直辖市是哪个	重庆直辖市是中国最后、最近设立的一个直辖
传说阎王爷身边最有名的两位长着动物面孔的勾魂使者叫什么	我知道的 是 牛头马面 重读几次,臆想着美句勾勒的情境,想着奔了去,石一条条小鱼邻近环绕黑压压一大片就像一支整齐待
美国哪条河流称为地上河	!!黄河
名著《西游记》中平顶山莲花洞的两个妖怪是金角大王和谁	银角大王
有“计算机界的诺贝尔奖”之称的是什么奖	图灵奖被称为“计算科学界的诺贝尔奖”,它创立于1960年,现在的奖金10万美元,由Intel公司赞助
谁最先发现天王星	天王星是由威廉·赫歇耳通过望远镜系统地搜寻,在1781年3月13日发现的,它是现代发现的第一颗行
贾岛《剑客》诗中“十年磨一剑”的下一句是什么	下一句是霜刃未曾试
2013年CBA中国职业篮球联赛总冠军时哪支球队	北京金隅 马布里带领的
美国第一位由影坛跨入政坛的总统是谁	里根
中国五大戏曲中的评剧产生于哪个省	1909年左右形成于唐山
秦朝时害死李斯、杀害秦二世的大宦官叫什么	赵高
歌曲《最浪漫的事》是哪位女歌手的作品	赵咏华 赵咏华
红军二万五千里长征开始于何年	1934年10月,中央红军主力离开中央革命根据地开始长征
我们用哪个书面语表示男方到女方家里结婚落户	书面语表示 入赘
城市里的温度比郊区的温度要高，这种情况叫什么效应	热岛效应
动漫《七龙珠》中由富人出钱举办的评出天下第一的武斗比赛是	天下第一武道会
第一个竞选总统的女性是谁	世界第一位女总统伊萨贝尔·庇隆自共和制度兴起以来的近二百年间,总统职务一向为男人所独霸
英国与法国之间的海峡叫什么名字	英吉利海峡
我国的哪个省是大熊猫的产地	B甘肃 在你列出的答案中只有甘肃是正确的. 此外,四川和陕西也有大熊猫分布
《麦田里的守望者》的作者是哪位美国作家	塞林
获得诺贝尔文学奖的作家莫言原名叫什么	原名叫 管谟业
苏轼的《念奴娇.赤壁怀古》中，“羽扇纶巾，谈笑间”的下一句是什么	樯橹灰飞烟灭
郭开贞是我国哪位著名文学家的原名	郭沫若 的原名
德国大众汽车的LOGO是由哪两个字母组成	VW 两个字母组成
李连杰电影《方世玉》中雷婷婷的父亲，经典台词“我是以德服人！”的人是谁	雷老虎
历时29年的“开元盛世”是唐朝哪位皇帝治下的盛世局面	唐玄宗
“龙舌兰”酒是哪个美洲国家的著名酒种类品种	墨西哥
在2004年和2008年奥运会上，与郭晶晶搭档获得女子三米板两连冠的是哪位女跳水运动员	在2008年第29届北京奥运会上,郭晶晶获得女子单人三米板冠军,并与吴敏霞搭档获得女子双人3米板冠军
古代科举制度是与我国哪个朝代	隋朝就有了,隋文帝借鉴北魏的制度建立的,隋炀帝完善,到唐朝就巅峰了
1945年，国共两党在哪个城市举行和平谈判，并签署《双十协定》	签署了《政府与中共代表会谈纪要》,又称《双十协定》
哪个岛屿最大	最大的岛:台湾岛 最大的瀑布:黄果树瀑布最大的咸水湖:青海湖
牛郎织女每年只能在农历的那一天才能相会	七月初七
抵达北极点的第一人是谁	第一个到达北极点的人-皮尔里 一个世纪以前,英国政府为了奖励北极探险者,曾拨出一笔资金,准备奖给第一个到达北极的探险家
化学元素周期表的第一位是什么元素	氢的质子数是1,氦的质子数是2,所以这么排的,氯的质子数是17,所以应该在17位 精锐化学老师
周星驰版《九品芝麻官》中扮演戚秦氏的女明星是谁	张敏
哪条河流将上海市分割成浦西和浦东，并成为上海重要的旅游景点	黄浦
“堪羡优伶有福，谁知公子无缘。”是《红楼梦》中对谁的判词	公子指的是贾宝玉，袭人早在宝玉落魄前就嫁给了蒋玉菡，所以说“公子无缘”
素有“巴蜀之地”“天府之国”之称的是我国哪个省	四川省,答案省
《哈利·波特》中，魔法界的第一大报纸叫什么名字	《预言家日报》,是小说《哈利·波特》系列中虚拟的报纸,在魔法界影响很大
金沙江发源于我国西部地区哪个省	金沙江是长江上游的一段,蜿延于四川、西藏、云南三省
“明天你是否会想起，昨日你写的日记”是老狼的哪首歌	老狼-同桌的你
“冲冠一怒为红颜”的“红颜”指的是哪位明末清初的苏州名妓	陈圆圆
张克帆原来是台湾哪个流行组合的主唱	红孩儿
中国古代诗歌体裁中，绝句是指有几句话的诗	4句
在鸿门宴上多次示意项羽杀掉刘邦，又指使项庄舞剑进行行刺的谋士是谁	秦末农民战争中为项羽主要谋士,被项羽尊为“亚父”
由法国人大卫贝尔创立并在电影《暴力街区13》中展示的极限运动叫什么	跑酷
清朝“太平天国”运动的发起人，后成为太平天国天王的人是谁	洪秀全
电影《画皮》的故事出自哪本清代文言短篇小说集	《聊斋志异》哦
被称为“绵羊之国”的大洋洲国家是哪里	澳大利亚被称为绵羊之国
我们常用什么植物来比喻无主见的人顺风两边倒	墙头草两边倒
最早提出冷战概念的是那位美国总统	杜鲁门 美国总
生铁又硬又脆是因为它含哪种元素过多	生铁的组成一般有C,Si,Mn,P,S五大元素,其中C碳和Si硅的含量和组织形态是决定生铁硬度的关键,含碳量,含硅量低,生铁的硬度上不去,生铁变脆有两种
我们在电视剧中听到的道教的咒语常用“太上老君什么令”	急急如律令
琼瑶剧《还珠格格》中，小燕子和紫薇在皇宫里居住的地方叫什么	琼瑶剧《还珠格格》中,小燕子和紫薇在皇宫里居住的地方叫漱芳斋
诸葛亮在生前最后一站在五丈原对阵的是谁	司马懿
“破釜沉舟”这个成语出自哪场项羽与秦朝军队之间的战争	“破釜沉舟”这个成语出自巨鹿一战
公认为全世界规模最大的网络搜索引擎是哪一个	谷
以钟表和军刀闻名于世的欧洲国家是	瑞士 以钟表和军刀闻名于世
篮球比赛中最多能带球走几步	3步 正确的说是 第3步的时候就要把球传出或投出~
我们通常喝的“拿铁”实际上是咖啡和什么饮料调和而成的	牛奶 调和而成的
用从餐饮企业回收的剩菜，非法提炼出来的劣质食用油叫什么	地沟油
我堂弟是高一的学生，人又高又瘦，过年回家我给他带什么礼物好	钢笔什么的!看他喜欢什么吧 熟人不用太注重外表,实用才好!
在升空不久后爆炸解体坠毁的美国正式使用的第二架航天飞机是什么号	挑战者号
世界上现存最古老的石拱桥是我国河北省什么桥	赵州桥
相传洛神是我国哪位中华民族的人文始祖的女儿	伏羲 伏羲
世界著名永久中立国之一，也是众多国际组织总部所在地的国家是	瑞士
2002年世界杯日本国家队身披23号战袍的主力门将叫什么	川口能活
我国最大的盐湖是哪个湖	青海湖 柴达木盆地的察尔汗盐湖
“走四方路迢迢水长长，迷迷茫茫一村又一庄”这首《走四方》的原唱是哪位男歌手	曲目:走四方 演唱者:韩磊[1] 走四方 路迢迢水长长 迷迷茫茫一村又一庄 看斜阳落下去又回来 地不老天不荒岁月长又长 走四方 路迢迢水长长 迷迷
“在天愿作比翼鸟，在地愿为连理枝”出自哪位唐朝诗人所写的《长恨歌》	白居易《长恨歌》
一加仑是多少立方米	1
哪块大陆最冷	最凉快的是 四季城市 昆明和哈尔滨 最热的是中国有三大火炉,是重庆,武汉,南京. 但他们都不是最热的城市,最热的是新疆吐鲁番
中国第一个进去美国WNBA打球的女子篮球运动员是谁	一、中国第一个进去美国WNBA打球的女子篮球运动员是郑海霞
在我国哪个城市需要预先摇号才能获得购买小轿车并且上牌的资格	在我国哪个城市需要预先摇号才能获得购买小轿车并且上牌的资 格? 北京
湖水中的“湖”是什么结构的汉字	左中右结构包含在左右结构内,以上字如果细说就可以说为左中右,粗点分就是左右
现今最流行的汽车是什么型号的	天幕贴膜吧,口碑都很不错
“风吹草低见牛羊”描绘的是哪个省的景色	答:内蒙古高
《射雕英雄传》中，杨铁心的干女儿叫什么名字	穆念慈
产煤最多的大陆在哪里	辽宁朝阳现有一2.7平方公里的钒钛磁铁矿源,寻求有实力单位或个人合作开发,如有兴趣请来实地考
位于玻利维亚和秘鲁两国交界，南美洲地势最高，面积最大的淡水湖是什么	的的客客湖
辛弃疾的词《南乡子。登京口北固有怀》中写到“生子当如”哪一位三国时期的人物	孙权
传说昭君出塞时随身抱着哪一种乐器	琵琶
俗语“一回生”的下一句是什么	二回
滑铁卢战败后，拿破仑被放逐到哪个岛屿	　　拿破仑一生最大的失败 　　滑铁卢战役之后,拿破仑被流放到南大西洋上一个叫做圣赫勒拿(St Helena)的孤岛上
“生于忧患，死于安乐”是出自我国哪部著名的儒家典籍	《孟子》
广州最著名的城市标识是五只什么动物	羊
清朝紫禁城中专为皇帝皇后准备食物的厨房，被称为什么	御膳房
人类最早发现的抗生素的发现者在哪年获得了诺贝尔生理医学奖	获得了
中央电视台有哪几个频道	中央电视台频道 CCTV-1：综合频道 CCTV-2：经济频道 CCTV-3：综艺频道 CCTV-4：中文国际频道 CCTV-5：体育频道 （2008年1月1日——
古代皇帝隐蔽自己的身份穿上平民衣服秘密来到民间探查被称作什么	微服私访
柳宗元的《江雪》中，“千山鸟飞绝”的下一句是什么	千山鸟飞绝, 万径人踪灭
我国在信封上填在六个方格中的阿拉伯数字叫做什么	邮政编码
“西湖景致六座桥，一枝杨柳一枝桃”描绘了杭州西湖的哪处景物	苏堤
古人称“盘缠”是指什么意思	路费
被誉为“20世纪最伟大的小说”的是法国作家罗曼·罗兰哪部代表作	约翰克里斯多夫
高考要求考生用墨的深度适合涂抹答题卡的什么铅笔	高考要求使用2b铅笔进行涂卡
赛扬M的CPU得达到多少HZ才行	512
什么洲的发达国家最多	欧洲
“日出江花红胜火，春来江水绿如蓝”出自白居易的哪首诗	忆江南 唐-白居易 江南好, 风景旧曾谙. 日出江花红胜火, 春来江水绿如蓝. 能不忆江南
哪位好莱坞巨星与吴彦祖，龚蓓苾合作了电影《形影不离》	凯文.史派西
电影《东成西就》中，段王爷成仙的条件是真心人对他说三遍什么话	我爱你
历史上汉朝的“文景之治”中的“文”是指哪个皇帝	汉文帝 汉文帝
以第一台有实用价值的蒸汽机的发明者命名，功率的单位是什么	功率的单位是 瓦特
张艺谋导演的《红高粱》，男主角余占鳌的扮演者是哪位著名演员	姜文
歇后语中用“扮猪吃哪种动物”来形容“大智若愚”	老虎
当年明月是哪部以明朝史事为题材小说作者的笔名	《明朝那些事儿》
光棍节在几月份	11.11
胡亥在李斯和哪个宦官的帮助下逼死扶苏而当上秦朝的二世皇帝	赵高
唐朝诗人白居易的《长恨歌》是描写唐玄宗和他的哪位妃子的诗句	杨贵妃 杨贵妃
我们常常用什么容器来形容“美丽却无肉涵的女人”	花瓶蛮
在意大利罗马的许愿池，为了实现愿望，人们许愿后会往池中扔什么	硬币
林升的诗句“山外青山楼外楼”的下一句是什么	诗词原文: 　　　题临安邸 　　南宋 林升 　　山外青山楼外楼, 　　西湖歌舞几时休. 　　暖风熏得游人醉, 　　直把杭州作汴州.美丽的西湖大部分
近期，由陈坤、赵薇、周迅、杨幂主演的魔幻爱情故事电影是	中文名 画皮Ⅱ , 画皮2 外文名 Painted Skin: The Resurrection 其它译名 转生术(中国台湾地区) 出品公司 宁夏电影,鼎龙达,华谊,麒麟 发行公司 华谊兄
电视剧《康熙王朝》中饰演孝庄皇太后的是哪位著名女演员	斯琴高娃,著名演员,成名作为《骆驼祥子》,她饰演了虎妞一角
现效力于CBA北京首钢篮球队，被称为“独狼”的前NBA巨星是谁	在NBA时期绰号“独狼”
世界上面积最大的高原是哪个高原	世界地理之最 世界面积最大的洲：亚洲(面积4400万平方公里)
福特Fiesta汽车一加仑汽油能够在高速公路上跑多少英里	1000
清朝政府统治中国多少年	1644
衡量光强弱的单位是什么	解答:解:(1)分析表中的6组数据,发现每一组的光强与电阻的乘积是一定的,都是36,所以电阻R与光强E的关系式为:R=36E;第
踏破铁鞋无觅处，下一句	得来全不费工夫
朝鲜战争爆发在哪年	抗美援朝战争中,第五次战役发生在1951年(选项B)
卡拉OK是哪国人发明的	卡拉OK最早是起源于日本,是日本人井上大佑的创意
出资修建了厦门大学的著名的爱国华侨领袖是谁	小题1:C小题1:B 略
2004年黎明和哪位北京出生的天后合作了影片《大城小事》	王菲.......... 王菲
电影《重庆森林》中，两位主要男演员是梁朝伟和谁	金城武
毛泽东《水调歌头.游泳》词中“不管风吹浪打”的下一句是什么	胜似闲庭信步
印度电影《三傻大闹宝莱坞》中，三位主人公的关系是什么	你是说Aamir Khan吧 兰彻 我个人认为不错的是 地球上的星星 未知死亡
薄伽丘的小说《十日谈》的故事背景是哪座意大利著名城市	佛罗伦萨
俄罗斯的君王被称为“沙皇”，那么文莱国王称为什么	文莱国王称 苏丹
戏曲及小说《杨家将》中，穆桂英是杨家将中谁的妻子	没有
二次世界大战时盟军在法国的什么地方登陆，开辟了欧洲战场	诺曼底
于2012年完婚的SHE成员ELLA的老公是谁	赖斯翔
开创“芸式唱腔”，代表作有《如果云知道》等歌曲的女歌手是谁	许茹芸
电视剧《双面胶》的原著作者是谁	《双面胶》根据网络小说改编,但结局做了大修改,丈夫并没有把妻子杀死,相对比较温
演唱了电影《狮子王》主题曲和《风中之烛》的是哪位英国著名音乐人	艾尔顿·约翰
广东话中的“大佬”是什么意思	"大佬"这个词通常指对男性的称呼,比如自己的哥哥也可以称作"大佬",在社会上也可称那些比自己年长或是上级的男性为"大佬",这是一个泛称,无贬义
世界上最长的山脉叫什么	安第斯山脉(Andes,Cordillera delos)(奇楚亚语:Antis)是陆地上最长的山脉,位于南美洲的西岸,范围从巴拿马一直到智利.山脉形成　　阿尔卑斯山脉上是古地
2000年奥运会中国得了多少枚金牌	48
《灌篮高手》中有红色头发并称自己是天才的是哪位人物	樱木花道
梁静茹的歌曲《勇气》MV中的女主角是由哪位台湾女艺人扮演的	?萧淑慎
我国古代的医学巨著《本才纲目》成熟与我国哪个朝代	成熟与我国 明代
夜盲症缺呐喊总维生素所导致	维生素A
出自《周易》，“兄弟同心”，后半句是什么	其利断金
人耳一般所能听到的声波频率是多少	20
著名哲学家黑格尔是哪个国家的	黑格尔:德国近代客观唯心主义哲学的代表、政治哲学家
今年几点立春	公历(阳历)2015年2月4日11时58分27秒, 农历(阴历)2014年腊月十六,星期三
我们常把什么人称为“三只手”	小偷
织女星位于哪个星座	织女星位于天琴座
2002年日韩世界杯足球赛的冠军球队是哪个国家队	里瓦尔多
上海除了浦东国际机场以外还有一座什么国际机场	虹桥机场
英国作家简.奥斯汀所作《最初的印象》后又改名为了什么	傲慢与偏见
常温通常指多少度	标注的保存方式大多为:常温保存
贝多芬的C小调第五交响曲又被称作什么	贝多芬《 C 小调第五交响曲》又被称作什么交响曲:命运
我国著名京剧演员梅葆玖是哪位京剧名角的儿子	梅兰芳
蔡依林的歌曲《说爱你》是有哪位天王级男歌手作曲的	周杰伦
外出旅游你会选择什么交通工具	保护铁路,人人有责 铁路是人民经济的动脉,它在我国建设中有重要的作用
国外译名为《105个男人和3个女人的故事》的是我国哪一部名著	水浒传
潘帕斯平原大部分在哪个国家境内	阿根廷
哪一条山脉的主轴分水岭为南欧和西亚的分界线	 高加索山脉 第二轮
在同一平面内，永不相交的两条直线称之为什么线	平行线
按词语性质来说，“一场电影”中的“一”是数词，那么“场”是什么性质的词语	量词
刚上映的《麦兜当当伴我心》中，为校长这一角色配音的是哪个香港演员	黄秋生
中关村位于北京的哪个区	在海淀区
中国营养学会推荐的钙供给量成人每天在600毫克到几百毫克之间	800哦
一年的四季是地球围绕太阳进行的哪种运动而形成的	地球绕太阳公转造成的
美国独立战争期间的主要领导人之一，起草《独立宣言》的美国第三任总统是谁	托马斯·杰斐逊
“天下第一村”华西村在我国哪个省	江苏
梦幻西游最厉害的门派是哪个	梦幻里没有那个门派是最厉害的,12门派都是相生相克的,这要看你怎么练而已,PK时看你怎么配合、策略的 至于要找容易组到队的有:DT、STL、LG、HS、MW
周星驰电影《九品芝麻官》中，饰演捕头“豹子头”的是哪个香港影星	徐锦
出自论语“知之为知之”的下一句是	不知为不知
在诗句中研究用“推”字还是“敲”字从而发明了推敲一词的是哪位诗人	"推敲”一词出自哪位唐代诗人贾岛的《诗话总龟》
“纳斯达克指数”是哪个国家股票交易的重要指数	美国股市三大指数:道琼斯工业指数、标准普尔500指数、纳斯达克综合指数
“喇嘛”藏语是什么意思	“喇嘛”是藏语“上师”之意
诺基亚手机有哪些型号	这里面有以往的排序,里面也有以上市机的报价 这个是诺基亚的cn主页 http://www.nokia.com.cn/ 诺基亚手机型号多样,市场定位也很复杂,根据型号字头的不
贾岛的名诗《寻隐者不遇》中“松下问童子”的下一句是什么	言师采药去
在十天干中排列在“甲乙丙丁”之后的两个是什么	戊己
俗话说“不求有功”下一句	 但求无过
方文山与五鬼之一的白福撞脸导致大家误以为他曾参演过哪部经典电视剧	新白娘子传奇
汉语拼音的单元音有a，o，e，i，u和哪个字母	只需要记住一点就够了:日语的发音时,嘴唇没有汉语发音那么圆,相对比较扁
《北京人》是哪位话剧大师创作于1940年的第四部杰作	曹禺《北京人》的主题是什么《北京人》是曹禺创作于1940年的第四部杰作
以羊为原型的2012年伦敦奥运会的吉祥物叫什么名字	没记错的话,应该是文洛克~
中国近代史上中国人民第一次大规模的反侵略武装斗争是什么斗争	A 它对英国侵略者的沉重打击,极大地鼓舞了中国人民不畏强暴,敢于同西方列强拼搏的斗争勇气.它是近代中国人民反侵略斗争的第一面光辉旗帜
第一支获得女足世界杯冠军的亚洲国家是哪个国家	日本
主演了《教父》三部曲和《闻香识女人》的美国男演员是谁	艾尔·
俗话说“乘兴而来”的后半句是什么	败兴而归兴尽而归兴尽而去
《红楼梦》中的女主人公林黛玉的亲身是哪种植物	绛珠仙草
名著《水浒传》中水泊梁山上立有一面大旗上面写了四个大字是	替天行道
端午节我们吃的粽子是用哪种传统主食作为主要原料	糯米
“我自横刀向天笑，去留肝胆两昆仑”是近代哪位著名人士的豪言	谭嗣同 的豪
《无以伦比》是哪位台湾男歌手演唱会的名字	周杰伦
“初出茅庐”中茅庐的本意指谁的住处	初出茅庐中的茅庐本意指诸葛亮的住处初出茅庐 ( chū chū máo lú ) 解 释 原比喻新露头脚.现比喻刚离开家庭或学校出来工作.缺乏经验.出 处 《
中国首位获得田径界顶级荣誉欧文斯奖的是哪位女子长跑运动员	王军霞 运动竞技3
号召推翻清朝统治的著作《革命军》的作者是哪位与秋瑾齐名的演说家	邹容
俗话说的“百善之首”是哪种品德	“百善之首” 孝
由高圆圆主演的电影《单身男女》的插曲是王菲演唱的哪首歌曲	《我愿意》
武侠瞎说《射雕英雄传》中，梅超风是被谁打瞎双眼的	黄药师,外号“东邪”,“天下五绝”之一,是金庸武侠小说《射雕英雄传》和《神雕侠侣》中的角色
2012年美国奥斯卡奖最佳影片奖是哪部影片	《艺术家》
电视剧《金粉世家》改编自哪位作家的同名小说	张恨水
在《北京爱情故事》中出演程峰外号“疯子”并是该片导演的人是谁	陈思成
俗语中形容人贪心不知足常用“吃着碗里”下一句是	看着锅
张艺谋执导的电影《秋菊打官司》中饰演秋菊的演员是是谁	巩俐
人无远虑	没有一个人说到点子上的
日本多少人口	12
想知道马的年龄可以看它的什么地方	以看它的 牙齿
越南货币的主币名称叫什么	盾
NBA主场在芝加哥的球队是	1896年,美国第一个篮球组织"全国篮球联盟(简称NBL)"成立,但当时篮球规则还不完善,组织机构也不健全,经过几个赛季后,该组织就名存实亡了
我国建筑行业工程质量最高荣誉奖叫什么奖	1 1
中医理论中“喜伤心，哀伤脾”那么什么伤肝	中医理论中“喜伤心,哀伤脾”怒伤肝
新中国成立初期的临时宪法叫什么名字	《中国人民政治协商会议共同纲领》
PLO的全称是什么	PoloRalphLauren(NYSE:RL)是一个美国服装品牌,创始人为服装设计师拉尔夫·劳伦(RalphLauren)
国际职业网球联合会的英文简称是哪三个字母	 ——ATP 2
刘德凯主演的电视剧《一帘幽梦》中紫菱的扮演者是哪位女明星	陈德容
2002年，一部改编自古龙笔下的经典侠盗人物并由吴奇隆主演的电视剧叫什么	《萧十一郎》
《西游记》中，要成功摘到人参果必须使用一种什么特殊的工具	金击子
我国的国球指的是哪项体育运动	中国的国球是乒乓球
公元前207年，项羽以5万军力一举击败20万秦军的是哪场著名战役	巨鹿之战
欧洲国家拉脱维亚的首都是哪个有"波罗的海跳动的心脏"美誉的城市	“波罗的海跳动的心脏” 里加
有声电影何时问世	有声电影何时问世
位于祖国正北方内蒙古自治区中部，简称为二连的是哪个市	二连浩特
《金石录》是由李清照和哪位金石学家一起撰写的	 赵
清朝“八旗”中的上三旗是正黄旗，正白旗和什么旗	满洲八旗有上三旗和下五旗之分
克里姆林宫是哪个国家的标志性建筑物	克里姆林宫是俄罗斯国家的标志性建筑
宋朝的开国皇帝是谁	宋太祖赵匡胤(927-976),中国北宋王朝的建立者,汉族,涿州(今河北)人
动漫《名侦探柯南》中，毛利兰是哪项武术运动的高手	空手道哦,而且多次获奖
被誉为“悲剧之父”的古希腊诗人是谁	埃斯库罗斯
哪位代表作有《同桌的你》的男歌手在2011年因醉驾被判入狱六个月	高晓松
全垒打是哪个体育项目的得分手段之一	哈佛大学注重对体育教学的培养,体育部以“全体学生的体育运动”为己任
法学经典《论法的精神》的作者是哪位法国大思想家	孟德斯鸠
TMJ有什么含义	组成:颞下颌关节,即TMJ
始于汉武帝刘彻，护卫皇帝、皇家、皇城的特殊军队叫什么	中国各朝各代古代护卫皇城的军队称御林军,亦称“羽林军”,顾名思义,在中国是护卫皇帝、皇家、皇城的特殊军
南宋开国皇帝，也就是宋高宗，叫什么名字	赵构/赵德基
我国体操运动员刘璇在哪个城市举办的奥运会上获得了“平衡木”这一项目的冠军	悉尼
由太平洋一座无人岛屿命名的一种女性泳装服侍叫什么	比基尼哦
由杨幂主演的清宫剧《宫》的剧名全称是什么	宫锁心玉
我们形容对阵两方都有不俗实力时会说“针尖对什么”	麦芒
电影《最爱》中与郭富城演对手戏的是哪位内地女明星	马伊琍 马伊琍
张国立版《铁齿铜牙纪晓岚》中，小月是谁饰演的	袁莉 袁莉
与韩愈并称为“韩柳”的唐宋八大家之一的人是谁	柳宗元
联想公司的开创者，现任联想集团名誉董事的企业家是	柳传志
《孔子家语》中良药苦口利于病，的下一句	忠言逆耳利于
长江最后注入我国哪个海	黄河最后流入渤海;长江最后流入东海!
在windows7系统中，我们常用哪个按键加上shift来切换输入法	Ctrl
黄梅戏中经典选段《天仙配》“树上的鸟儿成双对”的下一句是	绿水青山带笑颜
阿尔及利亚什么时候成为了殖民地	法国占的面积最大,但英国的殖民地人口最多,也就是最富庶的地区
美国哪座城市被称作“凤凰城”	菲尼克斯
我国著名运动员张娟娟是哪个项目运动员	射箭
国际象棋的棋盘共有多少个方格	8
《大河之舞》是爱尔兰什么物种的舞剧	踢踏舞 的舞剧
“侬”在上海话里面表示什么	是xia(第三声)ya(第一声)浓.谢谢你的意思
川菜以麻辣闻名，而其中的麻味来自于什么调料	花椒
被称为“核弹头”的乌克兰足球明星是谁	舍甫琴科
做意大利面条要用哪种烹饪用具	干燥的意大利面需要选用硬小麦粉,它的质地细腻,面筋含量非常高
《不得不爱》是由弦子和哪位男歌手共同演唱的	潘玮柏
154医院属于哪个部队呀	不,空军医院被原来的153医院兼并了
上海地区规定最低工资范围是多少	2014
毛宁的歌曲《涛声依旧》中，“这一张旧船票”的下一句是什么	这一张旧船票 能否登上你的客船 月落乌啼总是千年的风霜 涛声依旧不见当初的...2010-08-09 毛宁《涛声依旧》的歌词!最好给个这首歌的高清MV地址!
二战中著名的敦刻尔克大撤退的军事行动代号是什么计划	 发电机计划20、西
按照国际时区划分，我国新疆与北京的时差有几个小时	虽然中国统一使用北京时间,.北京在东八区,新疆在东六区,按照东加西减的规律,北京和新疆时差为2小时(比如北京17点,新
唐朝的都城长安是今天的哪座城市	唐朝的都城长安,即今日的陕西省西安
2004年由佘诗曼、黎姿、陈豪、邓萃雯主演的清宫争斗大戏是哪一步	《金枝欲孽》
世界知名的德国汽车品牌奔驰的总部设在哪个城市	斯图加特
海牛的食物是什么	这个是地衣中的一种,也就是我们常见的苔藓差不多,但是种类有区别,地衣(lichen)是真菌[1] 和光合生物(绿藻或蓝细菌)
在世界杯历史上获得冠军次数最多的是哪个球队	最多的 巴西
常用“精神胜利法”来自我安慰的是鲁迅笔下的哪个人物	阿 Q
美国人平均寿命多少	72
俄罗斯的领土大部分在哪块大陆	俄罗斯领土大部分地区处于北温带,气候多样,以温带大陆性气候为主,但北极圈以北属于寒带气候
《醉赤壁》、《曹操》等脍炙人口的歌曲都是哪位男歌手的代表作	林俊杰 的代表作
古巴还生产哪种牌子的白浪姆酒	Lucky Strike,Vegas,Hollywood,Popular,Cohiba(香烟版),还有一种好像叫H-upman吧,记不清了,大体就是这几种
被称为“西伯利亚的蓝眼睛”，也是世界上最深的淡水湖，是什么湖	贝尔加湖
葛洲坝工程使什么鱼濒临灭绝	中华鲟等洄游性繁殖生物等
“五花八门”中的“五花”指的是五行阵中的金、木、水、火和什么	金指的是一种代名词,模拟宇宙中属于金类别的事物
“磁器口”，“解放碑”是我国哪座西南地区城市的著名景点	重庆
被称为“西敏寺”的是英国哪座著名的大教堂	威斯敏斯特大教
幼发拉底河起源什么地方	两河流域,即幼发拉底河和底格里斯河流域,又称美索不达米亚,在希腊文中的含义为"河间之地"
历史上有热河之称的地方是哪里	历史上有热河之称的地方是: 河北省承德 承德原名热河,以水得名
平均温度最低的大陆是哪个洲	B.大陆的地势高峻,是世界平均海拔最高的大洲 其他条件北极都有但它没有地势高峻
在抗美援朝战争中，时任朝鲜的领导人是谁	金日成
安装在汽车前窗，用于清除阻碍视线的雨雪和尘土的部件是什么	雨刷器? 雨刷器是安装在风窗上的重要附件,它的作用是扫除风窗玻璃上妨碍视线的雨雪和尘
“地支”十二地支对应十二生肖，“辰”对应的是哪个生肖	龙
韩磊演唱的歌曲《向天再借五百年》是讲述哪位清朝皇帝故事的电视剧主题曲	康熙 康熙
电影《七宗罪》中老戏骨摩根弗里曼饰演的角色的职业是	?警察
出自元代名曲《琵琶记》中的名句，“我本将心向明月”的下一句是什么	奈何明月照沟渠
由周渝民赵又廷主演的台湾警匪偶像剧是什么	痞子英雄
撒哈拉沙漠的面积多大	世界排名第一的撒哈拉沙漠，总面积有800万平方公
八爪鱼的中文学名是什么	宝利通会议电话!
俄国十月革命发生在哪年	1917 1
一根钢管长10米，第一次截去它的7/第二次又截去余下的1/还剩多少米	10
美国历史上唯一一位蝉联了四届的总统是二战时期的哪位总统	罗斯福
叶念琛执导的电影《隐婚男女》是由陈奕迅和哪位台湾女星主演的	刘若英
相传《三国演义》中“水镜先生”的三个徒弟分别是诸葛亮、庞统和谁	徐庶
用以形容年轻人办事不稳重的俗语“嘴上无毛”的下一句是什么	办事不牢
苏轼《念奴娇.赤壁怀古》中“羽扇纶巾”是形容的哪位人物	周瑜 周瑜
人类器官中唯一有再生功能的器官是五脏中的哪一个	肝脏
美剧《绯闻女孩》中，布莱尔的饰演者是哪一位演员	莉顿·梅斯特
奥运会跳水比赛中，跳板跳水的跳板高几米	这名跳水运动员在水下:7-1-3=3米很高兴为您解答,【the1900】团队为您答题.请点击下面的【选为满意回答】按钮,如果有其他需要帮助的题目,您可以求助
《宰相刘罗锅》、《神医喜来乐》的男主角是我国哪位著名男演员	李保田
《骆驼祥子》这本书告诉了我们什么道理	《骆驼祥子》读后感 中国有这么一个作家,写了这么一本书,书里面有这么一个人
雨果小说《巴黎圣母院》中的男主角，钟楼怪人的名字叫什么	院门前的畸形儿,被称为长相丑陋又聋的钟楼怪人
维苏威火山爆发毁灭的庞贝城与赫库兰尼姆城是属于哪个古帝国的城市	古罗马 的城
我国最长的内流河是	我国最大的内流河—塔里木河
NBA历史上著名的奥本山宫事件中的奥本山宫是哪只NBA球队的主场	底特律活塞
俗语“金无足赤”的下一句是什么	人无完人
象牙有什么功能	象牙由牙质、软骨质及钙盐等独特的混合物形成
张信哲的歌曲《过火》中，“怎么忍心乖你犯了错”下一句是什么	是我给你自由过了火
哪一位瑞典化学家发明了炸药，并且设立了世界著名的科学奖项	诺贝尔
在《神雕侠侣》中绝情谷谷主公孙止的妇人是谁	裘千尺 裘千尺
被称为“中国最美乡村”的婺源是在我国的哪个省	My hometown is located in the northeast of jiangxi province, north of yiyang, known as "book township" and "district", is the national famous
主演《铁娘子》《穿普拉达的女魔头》等经典电影的好莱坞女演员是谁	?梅丽尔•斯特里普
清朝被称为“扬州八怪”的八个人中以画竹子闻名的是哪一位	当然是郑燮,即郑板桥
我国统一急救中心电话号码是多少	120
位于我国新疆阿勒泰地区，传说有湖怪出没的著名淡水湖叫什么名字	喀纳斯湖
朱重八是哪位皇帝的本名	是以前当过和尚和乞丐的明太祖朱元璋,他一手开辟了大明朝
以泡泡堂人物为角色的休闲赛车竞速游戏叫什么	跑跑卡丁车
著名演员陈建斌的现任妻子是哪位女演员	蒋勤勤
“皮卡丘”是哪一部动画片中的动漫形象	《宠物小精灵》
我们在比喻办事中途退缩的时候常称为打什么鼓	退堂鼓,.,/
享有“东方夏威夷”之称，泰国东海岸边的海景度假胜地叫什么	芭提雅,风景美如画啊
哪天被定为母亲节	一 儿童节,也叫"六一国际儿童节",二、每年5月的第2个星期日是母亲节,三、没年的六月第3个星期日是父亲节 儿童节,也叫"六一国际儿童节",每年的6
所谓“巴以冲突”指的是以色列和哪个国家之间的冲突	巴勒斯坦
CDMA手机上网速度有多快	满足你的要求的机子很多哈,并且以电信版的手机为主哈
东北三省是指黑龙江省和哪两个省	辽宁盛吉林盛黑龙江剩东北三省,简称东三省,地理名词,是对位于中国东北部的辽宁、吉林、黑龙江三省的总称
93版《霸王别姬》是由张国荣和哪位内地著名女演员共同主演的	巩俐
祝寿用语“寿比南山”中所指的终南山位于我国哪个省	终南山位于 陕西
郭晶晶的公公，霍启刚的父亲是谁	霍震霆
什么岛屿有自己的文明	选1嘛,“慕名”在这里的语境是:之前听过鼎鼎大名的日月潭,然后仰慕它的名气,所以就去了 所以这里的“慕名”就是“仰慕”的意思
《红楼梦》中的“蘅芜苑”是哪位书中主要人物的住所	薛宝钗
北京最有名的宫殿是什么	故宫 天安门 长城
北京奥运会个人获得8枚金牌的是哪位美国运动员	菲尔普斯
张学良第二任妻子伴他72年的妻子叫什么名字	 赵一荻 赵四
与郭德纲合作时间最长的金牌搭档叫什么名字	于谦
著名旅游城市“洛桑”位于哪个欧洲国家	欧洲国家 瑞士
英国作家托尔金所著系列书籍，并被改编成电影的《指环王》第二部的名字是	　　 约翰·罗纳德·瑞尔·托尔金,CBE(John Ronald Reuel Tolkien,1892年1月3日—1973年9月2日),英国语言学家、作家
提出“三纲五常”的思想家是西汉的哪位儒学大师	儒学董仲舒
被中国球迷昵称为“小德”的是哪位著名男子网球运动员	德约科维奇
“宁可我负天下人，不可天下人负我”是三国哪位人物的处事态度	曹操
澳门回归祖国在哪年	1999年12月20日
电视剧《大时代》当中的经典形象“小犹太”是由哪位昔日的“香港玉女”所扮演的	周慧敏83、在明末清初
创立深圳万科，喜欢登山越野的著名企业家是	著名企业家是 王石
“黑美人”是哪种水果的品种	西瓜
邓华德曾经是中国哪个项目男子国家队的主教练	邓华德曾经是中国哪个项目男子国家队的主教练? 篮球
李清照的《武陵春》中“物是人非事事休”的下一句	欲语泪先流
我们常把学生比喻成躲在什么塔里，超脱现实社会	躲在 象牙塔
庞海执导的电视剧《青春期撞上更年期》中女主角“贺飞儿”的饰演者是哪位女星	马伊琍
歇后语“千里送鹅毛”的下一句是什么	千里送鹅毛歇后语:礼轻情意重;礼薄情意重;物轻人意重【解释】:比喻礼物虽然微薄,却含有深厚的情谊
杜甫《赠花卿》中，“此曲只应天上有”的下一句	人间能得几回闻
”这句诗出自三国时期哪个人物之手	曹植 曹植
我们通常所说的不惑之年是指多少岁	40
位于四川省的“私奔码头”。相传是司马相如和谁私奔的地方	卓文
故宫是哪年建成的	北京故宫博物院，是明清两朝的皇宫
欧阳修的《诲学说》中，“玉不琢，不成器”的下一句是	北宋名士欧阳修,曾写《诲学说》劝戒子孙努力学习,提升自身修养
清朝“无冕女皇”慈禧太后的全名叫什么	2011-08-07 为什么慈禧太后叫慈禧
“可惜不是你，陪我到最后”是出自谁的歌曲	梁静茹
比利时说得最多的语言是什么	比利时是双语国家,法语和荷兰弗拉芒语都是官方语言 另外一般的比利时人大多会讲德语和英
军旗中可以在铁路线上任意行走的是哪个棋子	军旗中可以在铁路线上任意行走的是哪个棋子? 工兵
NBA球队中坐落于明尼苏达的是哪支球队	森林
古典名著《三国演义》中，诸葛亮最终病死在哪个古战场上	五丈原五丈
“国中国”圣马力诺的国土被哪个欧洲国家包围	意大利
《良友》画报1926年2月创刊，第一期封面照片上的女士是谁	蝴蝶
《红楼梦》中，“巧姐儿”是贾琏和谁的孩子	巧姐就是贾琏和王熙凤的女儿
历史上著名的泰坦尼克号是撞上什么而导致沉没的	冰山
三一重工主要创始人，现任三一集团董事长是谁	梁稳根,他是三一重工主要创始人,现任三一集团董事长,也就是主要的老板
人体每天需要补充多少核酸	1
北欧神话中被视作“诸神之王”的阿斯神族的最高神是谁	奥丁
小说《封神演义》中，“托塔天王”李靖曾经是什么关的总兵	小说《封神演义》中,“托塔天王”李靖曾经是陈塘关的总兵
唐代诗人孟郊的《游子吟》中“谁言寸草心”得下一句是什么	报得三春晓
我们常说“人在江湖”的后半句是什么	哪有不挨
我们常说“干什么事不误砍柴工”	磨刀 磨刀 磨刀 磨
我国里程最长的高速铁路是北京到哪座城市	我国里程最长的高速铁路是北京到哪座城市? 上海
哈尔滨有多少人口	　　哈尔滨市是中华人民共和国黑龙江省省会,是中国东北北部政治、经济、交通、文化中心,也是中国省辖市中面积最大、人口居第二位的特大城
著名足球解说员黄健翔在其“激情解说”中盛赞的“伟大的意大利左后卫”是谁	格罗索
2009年红极一时的歌曲，七月份的尾巴，是什么星座	这个是狮子座啊
故宫位于哪里	东城区,地图上一大方块,很好找,看你怎么去了~~想从哪门进? 坐地铁,天安门东下车,往西走一点,穿过天安门城楼,就是故宫南门了,午门
在电视剧《包青天》中，升堂时衙役们敲棍子并拖长音说的是哪两个字	威武
俄罗斯著名运动员伊辛巴耶娃是哪个项目的杰出运动员	俄罗斯著名运动员伊辛巴耶娃是撑杆跳高项目的杰出运动员
法国举办过哪几届奥运会	法国共举办过2届夏季奥运会,3届冬季奥运会
我国传说中审判人生前的行为并给与相应的惩罚，统领阴间的神仙是谁	阎罗王
冻疮由于皮肤哪部分受损而引起	冻疮是一种冬季常见病,以暴露部位出现充血性水肿红斑,遇温高时皮肤瘙痒为特征,严重者可能会出现患处皮肤糜烂、溃疡等现象
“朱古力”其实就是我们平时吃的哪种糖果类食物	这种说法不正确!因为3的倍数不一定都是奇数啊!有可能是7,8,9,10,11,12,13,天!因为这些数和3的乘积都是比20大比50小的数!
歌曲《不如跳舞》《记事本》是哪位香港女明星演唱的	陈慧琳 演唱的
最近刚刚去世的“查韦斯总统”是哪个国家的国家元首	委内瑞拉
“谁言寸草心，报得三春晖”出自唐朝诗人孟郊的哪首诗	游子
汉族地区佛教全国重点寺院“栖霞寺”位于江苏省哪个城市	南京
请问图书城里的见习经理是做哪些工作	管理方面的经理级人员 最好学过市场营销,工商管理等相关经营类的知识
在扑克牌中除了K、Q、J外还有哪种单个的英文字母的牌	 A
日本动画片《魔卡少女樱》中的男主角叫什么名字	李小狼
